gameId,blueWardsPlaced,blueWardsDestroyed,blueFirstBlood,blueKills,blueDeaths,blueAssists,blueEliteMonsters,blueDragons,blueHeralds,blueTowersDestroyed,blueTotalGold,blueAvgLevel,blueTotalExperience,blueTotalMinionsKilled,blueTotalJungleMinionsKilled,blueGoldDiff,blueExperienceDiff,blueCSPerMin,blueGoldPerMin,redWardsPlaced,redWardsDestroyed,redFirstBlood,redKills,redDeaths,redAssists,redEliteMonsters,redDragons,redHeralds,redTowersDestroyed,redTotalGold,redAvgLevel,redTotalExperience,redTotalMinionsKilled,redTotalJungleMinionsKilled,redGoldDiff,redExperienceDiff,redCSPerMin,redGoldPerMin
4469636302,13,1,1,5,7,5,0,0,0,0,15576,6.6,16352,221,35,-887,-1878,22.1,1557.6,14,2,0,7,5,7,1,0,1,0,16463,7.0,18230,197,68,887,1878,19.7,1646.3
4471240919,18,7,1,7,2,5,0,0,0,0,16284,7.2,18617,216,49,1496,1758,21.6,1628.4,17,6,0,2,7,3,0,0,0,0,14788,6.8,16859,225,44,-1496,-1758,22.5,1478.8
4514530513,12,1,0,6,11,5,0,0,0,0,16281,6.8,17569,209,53,-2082,-2125,20.9,1628.1,14,0,1,11,6,9,1,1,0,0,18363,7.4,19694,206,64,2082,2125,20.6,1836.3
4507906686,12,3,0,3,9,0,0,0,0,0,14502,6.8,17558,213,40,-3041,-1317,21.3,1450.2,15,3,1,9,3,7,2,1,1,0,17543,7.0,18875,223,50,3041,1317,22.3,1754.3
4419298949,17,2,1,5,9,5,0,0,0,0,15953,6.8,16466,223,51,-1047,-193,22.3,1595.3,16,1,0,9,5,10,1,1,0,0,17000,6.4,16659,179,68,1047,193,17.9,1700.0
4510942047,14,3,1,10,4,12,1,1,0,0,19017,7.2,19432,240,54,5117,4126,24.0,1901.7,15,5,0,4,10,4,0,0,0,0,13900,6.4,15306,193,34,-5117,-4126,19.3,1390.0
4455281479,45,3,1,10,3,5,1,0,1,0,18730,7.4,20389,232,58,5229,5136,23.2,1873.0,16,15,0,3,10,0,1,1,0,0,13501,6.4,15253,181,36,-5229,-5136,18.1,1350.1
4525297517,18,4,1,7,8,7,0,0,0,0,16927,6.8,17042,223,42,-498,-861,22.3,1692.7,21,3,0,8,7,7,0,0,0,0,17425,7.0,17903,228,51,498,861,22.8,1742.5
4510908073,16,4,0,7,12,4,0,0,0,0,16115,7.0,17647,193,52,-3032,-1859,19.3,1611.5,14,4,1,12,7,7,0,0,0,0,19147,7.2,19506,243,47,3032,1859,24.3,1914.7
4511211862,16,5,1,4,6,6,0,0,0,0,15246,6.6,16921,224,51,-1346,-2280,22.4,1524.6,17,2,0,6,4,10,1,1,0,0,16592,7.0,19201,221,56,1346,2280,22.1,1659.2
4519543034,50,2,1,8,6,7,0,0,0,0,17628,7.0,18881,233,69,1458,1753,23.3,1762.8,17,0,0,6,8,5,1,1,0,0,16170,7.0,17128,196,66,-1458,-1753,19.6,1617.0
4434652049,18,1,1,9,7,8,0,0,0,0,17875,7.0,18320,203,43,2561,1875,20.3,1787.5,14,0,0,7,9,6,0,0,0,0,15314,6.6,16445,179,32,-2561,-1875,17.9,1531.4
4435041315,53,2,0,3,8,3,0,0,0,0,14438,6.6,17107,199,39,-2502,-1811,19.9,1443.8,16,6,1,8,3,6,1,1,0,0,16940,7.0,18918,232,50,2502,1811,23.2,1694.0
4471522569,18,3,0,8,6,6,2,1,1,0,17316,7.0,18199,206,68,767,796,20.6,1731.6,17,3,1,6,8,8,0,0,0,0,16549,6.8,17403,216,52,-767,-796,21.6,1654.9
4512161240,17,5,1,8,7,4,1,0,1,0,17505,7.2,19027,236,48,1014,850,23.6,1750.5,18,2,0,7,8,5,1,1,0,0,16491,7.0,18177,201,60,-1014,-850,20.1,1649.1
4502652617,11,0,1,5,5,3,1,0,1,0,16993,7.0,18944,241,67,1140,-531,24.1,1699.3,12,1,0,5,5,5,1,1,0,0,15853,7.0,19475,231,60,-1140,531,23.1,1585.3
4496506174,12,3,0,4,5,4,1,1,0,0,15297,6.6,17644,201,48,-502,-413,20.1,1529.7,20,3,1,5,4,7,0,0,0,0,15799,7.0,18057,209,52,502,413,20.9,1579.9
4509810925,16,1,0,6,6,7,1,1,0,0,15703,6.8,16893,191,40,-951,-1116,19.1,1570.3,12,3,1,6,6,8,0,0,0,0,16654,7.2,18009,221,51,951,1116,22.1,1665.4
4476823895,11,1,0,14,9,14,0,0,0,0,19170,7.0,18219,193,42,3062,2772,19.3,1917.0,11,1,1,9,14,13,0,0,0,0,16108,6.2,15447,142,38,-3062,-2772,14.2,1610.8
4526340314,18,3,0,10,4,4,0,0,0,0,18581,7.6,19769,249,55,3301,3347,24.9,1858.1,17,3,1,4,10,4,1,1,0,0,15280,6.6,16422,213,40,-3301,-3347,21.3,1528.0
4521141192,41,2,1,5,8,3,0,0,0,0,16042,7.0,18424,238,56,-686,-893,23.8,1604.2,16,4,0,8,5,4,2,1,1,0,16728,7.2,19317,216,71,686,893,21.6,1672.8
4481573191,16,3,1,12,11,12,0,0,0,0,19460,7.4,19643,223,43,778,1443,22.3,1946.0,11,3,0,11,12,14,0,0,0,0,18682,7.0,18200,234,32,-778,-1443,23.4,1868.2
4512249103,12,1,0,5,9,2,0,0,0,0,16055,6.8,17800,226,50,6,1624,22.6,1605.5,13,1,1,9,5,15,1,1,0,0,16049,6.6,16176,160,40,-6,-1624,16.0,1604.9
4476661936,18,2,0,9,14,9,1,0,1,0,16897,6.4,15328,159,26,-2191,-1391,15.9,1689.7,17,3,1,14,9,19,1,1,0,0,19088,6.8,16719,185,39,2191,1391,18.5,1908.8
4451628627,15,1,0,2,10,1,1,0,1,0,13726,6.2,16098,184,52,-4474,-5216,18.4,1372.6,16,3,1,10,2,8,1,1,0,0,18200,7.6,21314,236,68,4474,5216,23.6,1820.0
4525063445,15,2,0,8,8,8,1,0,1,0,16836,6.8,17998,228,49,-52,-301,22.8,1683.6,15,2,1,8,8,12,0,0,0,0,16888,7.0,18299,186,52,52,301,18.6,1688.8
4494489796,38,6,1,9,8,12,1,1,0,0,17396,7.0,17804,205,48,-377,842,20.5,1739.6,19,4,0,8,9,10,1,0,1,0,17773,6.6,16962,223,40,377,-842,22.3,1777.3
4489610155,17,3,1,5,11,7,0,0,0,0,15897,6.8,17075,215,51,-3048,-3175,21.5,1589.7,35,4,0,11,5,8,1,1,0,0,18945,7.4,20250,245,48,3048,3175,24.5,1894.5
4521093374,43,1,1,6,8,10,0,0,0,0,15629,6.8,16806,176,52,-1537,-926,17.6,1562.9,15,4,0,8,6,9,0,0,0,0,17166,7.0,17732,186,36,1537,926,18.6,1716.6
4519133834,16,2,0,6,16,6,1,1,0,0,14999,6.4,15530,192,44,-6027,-3955,19.2,1499.9,18,4,1,16,6,24,0,0,0,0,21026,7.4,19485,228,52,6027,3955,22.8,2102.6
4495074549,16,4,1,3,6,3,0,0,0,0,14910,6.6,15466,195,36,-821,-2540,19.5,1491.0,44,3,0,6,3,4,1,1,0,0,15731,6.8,18006,206,67,821,2540,20.6,1573.1
4468897827,43,3,1,2,4,1,1,1,0,0,15377,7.0,17617,229,56,-166,-712,22.9,1537.7,79,7,0,4,2,2,0,0,0,0,15543,7.0,18329,214,47,166,712,21.4,1554.3
4452292260,37,1,0,9,11,8,1,1,0,0,17060,6.6,17118,179,36,-896,-661,17.9,1706.0,16,15,1,11,9,14,0,0,0,0,17956,7.0,17779,200,52,896,661,20.0,1795.6
4452269008,11,0,1,7,12,12,0,0,0,0,16880,7.0,17307,216,43,-2125,-3115,21.6,1688.0,14,1,0,12,7,12,1,0,1,0,19005,7.4,20422,221,33,2125,3115,22.1,1900.5
4442484650,13,2,0,2,9,1,0,0,0,0,13569,6.0,14129,165,52,-3535,-3197,16.5,1356.9,15,0,1,9,2,11,2,1,1,0,17104,7.0,17326,215,44,3535,3197,21.5,1710.4
4516639706,13,2,0,2,2,3,0,0,0,0,15397,6.8,17958,247,44,908,-79,24.7,1539.7,16,2,1,2,2,1,2,1,1,0,14489,6.8,18037,221,60,-908,79,22.1,1448.9
4518499489,16,2,0,2,11,2,0,0,0,0,13494,5.8,14660,213,24,-5020,-4792,21.3,1349.4,14,3,1,11,2,9,1,1,0,0,18514,7.4,19452,246,57,5020,4792,24.6,1851.4
4520742612,40,3,1,4,8,6,2,1,1,0,15404,6.6,16706,203,49,-1332,-1998,20.3,1540.4,18,5,0,8,4,4,0,0,0,0,16736,7.2,18704,204,45,1332,1998,20.4,1673.6
4523957266,19,2,0,4,7,2,0,0,0,0,15649,7.2,18614,234,66,-1975,-1115,23.4,1564.9,24,4,1,7,4,7,1,1,0,0,17624,7.2,19729,243,55,1975,1115,24.3,1762.4
4495005465,11,2,0,6,8,7,0,0,0,0,16924,6.8,17938,233,47,-465,-436,23.3,1692.4,81,1,1,8,6,10,0,0,0,0,17389,7.2,18374,214,42,465,436,21.4,1738.9
4499598970,24,2,1,3,2,6,1,1,0,0,15335,6.8,17847,239,47,187,-954,23.9,1533.5,19,2,0,2,3,1,0,0,0,0,15148,6.8,18801,248,63,-187,954,24.8,1514.8
4515922365,11,1,1,8,9,6,0,0,0,0,17424,7.2,18146,224,37,-618,-669,22.4,1742.4,17,2,0,9,8,8,0,0,0,0,18042,7.0,18815,223,57,618,669,22.3,1804.2
4469416246,15,4,1,10,8,7,1,0,1,0,17664,7.0,18757,233,53,563,442,23.3,1766.4,13,4,0,8,10,6,0,0,0,0,17101,7.0,18315,219,39,-563,-442,21.9,1710.1
4494472776,16,2,1,4,8,5,0,0,0,0,16055,6.8,17241,252,50,-1176,-1456,25.2,1605.5,61,1,0,8,4,9,1,1,0,0,17231,7.0,18697,225,51,1176,1456,22.5,1723.1
4524434375,38,4,0,9,9,14,1,1,0,0,17630,7.0,18364,230,50,13,2012,23.0,1763.0,15,2,1,9,9,10,0,0,0,0,17617,6.4,16352,165,42,-13,-2012,16.5,1761.7
4491765762,15,3,1,5,3,7,1,1,0,0,16885,7.2,18326,229,52,2657,2468,22.9,1688.5,15,1,0,3,5,4,0,0,0,0,14228,6.4,15858,200,36,-2657,-2468,20.0,1422.8
4527093291,10,2,0,4,9,2,0,0,0,0,14010,6.4,15841,170,45,-3956,-2930,17.0,1401.0,15,2,1,9,4,9,1,1,0,0,17966,7.0,18771,207,62,3956,2930,20.7,1796.6
4523059751,15,3,0,4,4,3,0,0,0,0,16669,7.4,19026,266,51,565,275,26.6,1666.9,19,4,1,4,4,5,1,1,0,0,16104,7.2,18751,238,56,-565,-275,23.8,1610.4
4523319289,13,2,0,3,5,5,1,1,0,0,15597,7.2,18348,249,55,200,532,24.9,1559.7,10,1,1,5,3,2,0,0,0,0,15397,7.0,17816,203,60,-200,-532,20.3,1539.7
4497737191,17,3,0,3,3,2,1,1,0,0,14409,6.4,17030,212,44,-108,-914,21.2,1440.9,42,3,1,3,3,5,1,0,1,0,14517,7.0,17944,200,50,108,914,20.0,1451.7
4524479196,11,2,0,1,8,2,0,0,0,0,13841,6.8,16368,216,49,-5048,-4145,21.6,1384.1,18,0,1,8,1,6,1,1,0,0,18889,7.4,20513,268,53,5048,4145,26.8,1888.9
4519295854,11,1,0,8,8,6,1,1,0,0,16002,6.8,17397,177,52,-1260,-1183,17.7,1600.2,11,2,1,8,8,13,0,0,0,0,17262,7.0,18580,209,56,1260,1183,20.9,1726.2
4519711392,12,2,0,5,7,6,1,1,0,0,16484,6.6,17799,242,44,-94,-844,24.2,1648.4,13,4,1,7,5,7,0,0,0,0,16578,7.0,18643,201,48,94,844,20.1,1657.8
4520552077,17,2,0,6,6,9,0,0,0,0,17528,6.8,18106,216,55,1376,1018,21.6,1752.8,16,3,1,6,6,5,1,1,0,0,16152,6.8,17088,217,38,-1376,-1018,21.7,1615.2
4520303900,14,1,0,5,3,5,1,0,1,1,17531,7.4,19484,241,46,2351,1317,24.1,1753.1,12,2,1,3,5,3,1,1,0,0,15180,7.0,18167,223,44,-2351,-1317,22.3,1518.0
4523290421,17,3,1,7,10,7,0,0,0,0,16995,6.8,17908,217,44,-1666,-759,21.7,1699.5,17,5,0,10,7,15,1,1,0,0,18661,7.0,18667,243,60,1666,759,24.3,1866.1
4522612481,14,1,1,7,5,7,1,1,0,0,16747,7.0,18330,202,48,482,-670,20.2,1674.7,12,0,0,5,7,2,0,0,0,0,16265,7.2,19000,225,60,-482,670,22.5,1626.5
4524391418,11,2,1,7,3,6,0,0,0,0,18351,7.4,19217,222,72,3827,3161,22.2,1835.1,15,1,0,3,7,3,1,1,0,0,14524,6.4,16056,201,53,-3827,-3161,20.1,1452.4
4516642389,17,4,0,7,7,7,0,0,0,0,16683,7.2,18315,231,48,-396,481,23.1,1668.3,11,2,1,7,7,5,2,1,1,0,17079,6.8,17834,246,42,396,-481,24.6,1707.9
4459302014,13,4,1,10,5,10,0,0,0,0,18588,7.2,18890,229,48,2824,1346,22.9,1858.8,15,2,0,5,10,3,0,0,0,0,15764,6.8,17544,214,44,-2824,-1346,21.4,1576.4
4500869291,20,3,0,11,8,9,2,1,1,0,17598,7.2,18935,225,52,1380,1402,22.5,1759.8,15,1,1,8,11,8,0,0,0,0,16218,6.8,17533,192,44,-1380,-1402,19.2,1621.8
4449098709,13,1,1,11,1,10,1,1,0,1,19673,7.6,21261,209,68,5797,4456,20.9,1967.3,13,0,0,1,11,0,0,0,0,0,13876,6.8,16805,218,56,-5797,-4456,21.8,1387.6
4433044293,19,2,0,3,5,3,1,1,0,0,14587,6.8,16414,222,48,-2395,-2214,22.2,1458.7,26,4,1,5,3,6,1,0,1,0,16982,7.0,18628,254,60,2395,2214,25.4,1698.2
4500969202,56,4,0,0,6,0,1,1,0,0,14439,6.8,17416,264,45,-2696,-2455,26.4,1443.9,19,22,1,6,0,9,0,0,0,0,17135,7.4,19871,250,48,2696,2455,25.0,1713.5
4521063765,14,4,0,3,3,4,1,1,0,0,15138,7.0,18807,194,66,-105,1086,19.4,1513.8,16,2,1,3,3,3,0,0,0,0,15243,7.0,17721,235,55,105,-1086,23.5,1524.3
4467720133,15,8,1,10,4,10,2,1,1,0,18818,7.4,19037,215,60,4107,1820,21.5,1881.8,18,3,0,4,10,2,0,0,0,0,14711,6.8,17217,209,49,-4107,-1820,20.9,1471.1
4521559243,13,1,1,7,0,8,0,0,0,0,17269,7.2,19988,244,52,3425,3823,24.4,1726.9,15,2,0,0,7,0,1,1,0,0,13844,6.6,16165,228,52,-3425,-3823,22.8,1384.4
4480445150,16,0,0,4,5,6,2,1,1,0,16127,6.8,17245,235,55,1210,1410,23.5,1612.7,19,4,1,5,4,3,0,0,0,0,14917,6.4,15835,191,40,-1210,-1410,19.1,1491.7
4511678140,16,2,1,7,9,10,1,0,1,1,19036,7.2,19444,248,60,2346,751,24.8,1903.6,37,1,0,9,7,14,1,1,0,0,16690,7.4,18693,197,53,-2346,-751,19.7,1669.0
4521223652,15,1,0,4,3,4,1,1,0,0,15237,7.0,17965,205,60,724,2025,20.5,1523.7,49,3,1,3,4,4,1,0,1,0,14513,6.2,15940,206,32,-724,-2025,20.6,1451.3
4447263506,16,1,1,5,1,0,1,1,0,0,16117,7.2,19109,221,60,2975,3977,22.1,1611.7,13,2,0,1,5,1,0,0,0,0,13142,6.2,15132,182,42,-2975,-3977,18.2,1314.2
4440119391,24,3,1,14,4,14,0,0,0,0,21095,7.6,21242,249,67,5802,5396,24.9,2109.5,13,5,0,4,14,5,1,1,0,0,15293,6.2,15846,186,44,-5802,-5396,18.6,1529.3
4494013671,29,1,1,3,6,2,2,1,1,0,14740,6.6,16655,201,44,-1402,-2295,20.1,1474.0,21,2,0,6,3,9,0,0,0,0,16142,7.0,18950,233,51,1402,2295,23.3,1614.2
4515353277,18,3,1,6,10,8,0,0,0,0,16481,6.8,17069,201,48,-1334,-1607,20.1,1648.1,14,4,0,10,6,12,1,1,0,0,17815,7.2,18676,198,44,1334,1607,19.8,1781.5
4526553053,16,19,0,9,8,9,1,1,0,0,17617,7.0,18621,245,42,-642,311,24.5,1761.7,35,1,1,8,9,11,0,0,0,0,18259,6.8,18310,236,44,642,-311,23.6,1825.9
4515744642,19,4,0,2,6,2,0,0,0,0,14790,6.8,18612,223,71,-3075,-244,22.3,1479.0,16,0,1,6,2,7,1,1,0,0,17865,7.0,18856,266,47,3075,244,26.6,1786.5
4502966435,16,3,1,4,4,1,1,0,1,0,16516,7.4,19168,259,60,1234,1855,25.9,1651.6,9,2,0,4,4,5,0,0,0,0,15282,6.8,17313,229,44,-1234,-1855,22.9,1528.2
4505469911,16,7,0,7,7,7,1,1,0,0,16352,6.8,18216,224,56,-435,-1431,22.4,1635.2,18,4,1,7,7,7,0,0,0,0,16787,7.2,19647,233,47,435,1431,23.3,1678.7
4465674600,20,1,1,4,9,1,1,1,0,0,16223,6.8,17597,222,63,-2086,-1696,22.2,1622.3,15,3,0,9,4,8,0,0,0,0,18309,7.0,19293,228,52,2086,1696,22.8,1830.9
4448358133,20,0,1,5,7,9,0,0,0,0,16072,6.8,16945,236,32,-184,408,23.6,1607.2,12,5,0,7,5,7,0,0,0,0,16256,6.8,16537,195,39,184,-408,19.5,1625.6
4514548275,20,4,1,7,3,8,2,1,1,0,17507,7.2,19641,250,64,2790,3073,25.0,1750.7,169,2,0,3,7,3,0,0,0,0,14717,6.6,16568,209,47,-2790,-3073,20.9,1471.7
4524367614,13,0,1,5,10,6,0,0,0,0,15366,6.8,16496,200,40,-2698,-2969,20.0,1536.6,17,0,0,10,5,8,2,1,1,0,18064,7.2,19465,221,52,2698,2969,22.1,1806.4
4505239658,15,2,0,4,5,2,1,0,1,0,14644,6.8,17550,222,48,-1367,-412,22.2,1464.4,19,2,1,5,4,6,0,0,0,0,16011,7.0,17962,201,56,1367,412,20.1,1601.1
4523121371,16,2,1,5,13,4,0,0,0,0,14988,6.2,15585,186,40,-3562,-3319,18.6,1498.8,10,3,0,13,5,20,0,0,0,0,18550,7.2,18904,208,52,3562,3319,20.8,1855.0
4509069463,15,3,1,7,5,8,2,1,1,0,17788,7.0,18965,248,53,1767,1408,24.8,1778.8,11,1,0,5,7,4,0,0,0,0,16021,7.0,17557,221,56,-1767,-1408,22.1,1602.1
4472632367,17,3,0,7,6,8,1,0,1,0,17882,7.2,19474,233,55,2689,1875,23.3,1788.2,13,2,1,6,7,5,0,0,0,0,15193,6.8,17599,218,32,-2689,-1875,21.8,1519.3
4520888635,16,4,1,7,6,7,0,0,0,0,16160,6.8,17319,206,60,-106,-62,20.6,1616.0,57,2,0,6,7,5,0,0,0,0,16266,6.8,17381,229,36,106,62,22.9,1626.6
4518035453,9,1,0,5,9,5,0,0,0,0,15942,6.8,17493,215,48,-1590,-1375,21.5,1594.2,40,3,1,9,5,13,1,1,0,0,17532,7.0,18868,221,70,1590,1375,22.1,1753.2
4511502291,13,4,0,7,8,6,1,0,1,0,16464,6.6,17075,209,52,166,395,20.9,1646.4,16,1,1,8,7,12,1,1,0,0,16298,6.6,16680,167,40,-166,-395,16.7,1629.8
4524784360,14,2,1,7,6,2,1,0,1,0,16756,7.0,18790,239,52,773,1285,23.9,1675.6,18,0,0,6,7,6,1,1,0,0,15983,6.8,17505,190,44,-773,-1285,19.0,1598.3
4499876537,12,0,0,4,13,3,0,0,0,0,14349,6.6,16821,159,49,-6973,-3705,15.9,1434.9,19,0,1,13,4,11,1,1,0,1,21322,7.6,20526,263,60,6973,3705,26.3,2132.2
4505754774,28,6,0,14,6,22,0,0,0,0,19890,6.8,17275,174,46,4401,2185,17.4,1989.0,16,2,1,6,14,6,1,1,0,0,15489,6.2,15090,204,36,-4401,-2185,20.4,1548.9
4470670940,18,3,1,6,6,7,0,0,0,0,16247,7.4,19667,218,52,266,1738,21.8,1624.7,14,5,0,6,6,8,1,1,0,0,15981,7.0,17929,213,56,-266,-1738,21.3,1598.1
4521175049,15,3,0,3,5,3,1,1,0,0,15809,6.8,17675,214,63,-1462,-1833,21.4,1580.9,17,2,1,5,3,8,1,0,1,0,17271,7.4,19508,232,56,1462,1833,23.2,1727.1
4432850060,19,3,1,9,6,11,0,0,0,0,17561,7.0,19152,207,68,2134,1500,20.7,1756.1,15,4,0,6,9,2,1,1,0,0,15427,7.0,17652,204,48,-2134,-1500,20.4,1542.7
4471395182,17,2,0,13,12,13,0,0,0,0,19714,7.2,18151,186,40,1460,2108,18.6,1971.4,15,1,1,12,13,13,0,0,0,0,18254,6.6,16043,200,35,-1460,-2108,20.0,1825.4
4450360531,15,2,1,14,4,15,1,1,0,0,19331,7.0,19211,213,46,4289,3990,21.3,1933.1,14,1,0,4,14,7,0,0,0,0,15042,6.4,15221,171,36,-4289,-3990,17.1,1504.2
4520686446,15,4,0,6,4,10,1,1,0,0,16386,6.6,17424,216,45,742,-654,21.6,1638.6,19,2,1,4,6,3,0,0,0,0,15644,6.8,18078,255,37,-742,654,25.5,1564.4
4498673478,14,1,1,7,6,9,2,1,1,0,16574,6.8,17377,197,42,969,-42,19.7,1657.4,13,2,0,6,7,8,0,0,0,0,15605,6.6,17419,194,37,-969,42,19.4,1560.5
4510866403,17,1,0,2,3,2,0,0,0,0,14971,7.0,18121,228,49,-682,-89,22.8,1497.1,18,4,1,3,2,5,1,1,0,0,15653,7.2,18210,252,49,682,89,25.2,1565.3
4511777552,13,2,0,7,7,12,0,0,0,0,16449,7.0,18091,211,39,-986,-484,21.1,1644.9,10,3,1,7,7,13,1,1,0,0,17435,7.2,18575,238,53,986,484,23.8,1743.5
4527240593,38,1,1,9,5,8,0,0,0,0,18174,7.0,18815,232,55,3242,2227,23.2,1817.4,34,3,0,5,9,7,1,1,0,0,14932,6.8,16588,191,40,-3242,-2227,19.1,1493.2
4464183105,17,5,1,1,3,1,0,0,0,0,15221,6.8,17418,266,45,-179,-463,26.6,1522.1,14,4,0,3,1,4,1,1,0,0,15400,6.6,17881,240,46,179,463,24.0,1540.0
4524953398,15,2,1,5,13,3,0,0,0,0,15557,6.6,16910,190,65,-4197,-2772,19.0,1555.7,21,0,0,13,5,20,1,1,0,0,19754,7.2,19682,228,46,4197,2772,22.8,1975.4
4521242429,16,4,0,4,11,4,0,0,0,0,15120,6.4,16083,189,44,-3181,-2898,18.9,1512.0,56,3,1,11,4,14,0,0,0,0,18301,7.4,18981,214,48,3181,2898,21.4,1830.1
4473648726,18,2,0,6,7,7,1,1,0,0,16527,6.6,16322,229,40,94,-487,22.9,1652.7,94,3,1,7,6,11,0,0,0,0,16433,6.8,16809,190,37,-94,487,19.0,1643.3
4523747922,16,3,0,2,6,3,0,0,0,0,14752,6.8,17935,228,61,-2181,-1293,22.8,1475.2,17,3,1,6,2,8,1,1,0,0,16933,7.2,19228,252,52,2181,1293,25.2,1693.3
4492408398,38,0,1,2,3,2,0,0,0,0,15414,7.2,18476,232,68,-304,-1063,23.2,1541.4,11,1,0,3,2,1,1,1,0,0,15718,7.4,19539,237,67,304,1063,23.7,1571.8
4512990467,18,3,1,7,11,9,1,0,1,0,17132,6.6,16777,198,56,-2250,-1591,19.8,1713.2,17,5,0,11,7,17,1,1,0,0,19382,7.0,18368,196,52,2250,1591,19.6,1938.2
4519568635,16,2,0,3,9,4,0,0,0,0,15279,6.8,17220,206,67,-3702,-1251,20.6,1527.9,17,3,1,9,3,14,2,1,1,1,18981,7.0,18471,237,52,3702,1251,23.7,1898.1
4516913135,15,2,0,5,14,3,0,0,0,0,15424,6.8,17248,191,35,-4585,-3125,19.1,1542.4,15,4,1,14,5,13,2,1,1,0,20009,7.4,20373,228,56,4585,3125,22.8,2000.9
4473146660,13,9,0,3,9,5,0,0,0,0,14724,6.4,16015,218,42,-3541,-2434,21.8,1472.4,43,2,1,9,3,13,1,1,0,0,18265,6.8,18449,244,56,3541,2434,24.4,1826.5
4469758473,16,2,1,9,3,10,1,1,0,1,20273,7.2,19742,254,51,4982,1971,25.4,2027.3,39,0,0,3,9,4,0,0,0,0,15291,6.8,17771,195,74,-4982,-1971,19.5,1529.1
4467040856,14,4,1,6,2,4,0,0,0,0,16636,7.2,18741,225,40,1833,899,22.5,1663.6,16,0,0,2,6,3,1,1,0,0,14803,6.8,17842,201,63,-1833,-899,20.1,1480.3
4525996242,34,6,0,4,11,7,0,0,0,0,15790,6.8,17533,208,47,-2878,-1184,20.8,1579.0,24,10,1,11,4,13,0,0,0,0,18668,7.0,18717,234,44,2878,1184,23.4,1866.8
4527613932,12,2,1,6,3,5,0,0,0,0,16007,6.8,17907,221,40,1201,695,22.1,1600.7,12,0,0,3,6,3,1,1,0,0,14806,6.8,17212,209,40,-1201,-695,20.9,1480.6
4431859691,15,6,0,7,3,7,0,0,0,0,16592,7.0,19045,220,40,1709,880,22.0,1659.2,15,2,1,3,7,1,1,1,0,0,14883,7.2,18165,203,60,-1709,-880,20.3,1488.3
4505127174,18,2,1,6,2,5,1,1,0,0,16953,7.2,19642,248,52,2348,2678,24.8,1695.3,18,4,0,2,6,3,0,0,0,0,14605,6.6,16964,225,56,-2348,-2678,22.5,1460.5
4487273871,17,1,0,2,6,0,0,0,0,0,13465,6.2,15462,191,43,-3179,-937,19.1,1346.5,15,2,1,6,2,6,1,1,0,0,16644,6.6,16399,226,43,3179,937,22.6,1664.4
4504218581,17,2,0,8,3,10,1,1,0,0,17810,7.6,19743,248,57,3866,3496,24.8,1781.0,19,1,1,3,8,1,0,0,0,0,13944,6.4,16247,191,41,-3866,-3496,19.1,1394.4
4527878058,18,2,1,12,6,13,0,0,0,0,18573,7.2,19391,207,46,2639,2364,20.7,1857.3,16,6,0,6,12,6,0,0,0,0,15934,6.6,17027,197,38,-2639,-2364,19.7,1593.4
4525582904,18,2,0,5,7,5,0,0,0,0,15195,6.6,16429,187,59,-2539,-1637,18.7,1519.5,33,0,1,7,5,5,0,0,0,1,17734,6.6,18066,223,40,2539,1637,22.3,1773.4
4523860316,29,5,0,6,8,10,0,0,0,0,17394,7.0,18465,213,68,-14,-776,21.3,1739.4,42,3,1,8,6,8,2,1,1,0,17408,7.2,19241,215,63,14,776,21.5,1740.8
4478461160,14,2,1,9,0,8,0,0,0,0,17086,7.2,19170,221,49,3655,2743,22.1,1708.6,37,2,0,0,9,0,1,1,0,0,13431,6.4,16427,198,60,-3655,-2743,19.8,1343.1
4454340438,15,1,0,0,4,0,0,0,0,0,13580,6.4,16571,207,48,-4279,-4529,20.7,1358.0,37,2,1,4,0,2,2,1,1,0,17859,7.6,21100,266,82,4279,4529,26.6,1785.9
4516121686,25,1,1,6,6,11,1,1,0,0,17831,6.8,18269,240,43,965,-878,24.0,1783.1,17,2,0,6,6,7,0,0,0,0,16866,7.0,19147,233,51,-965,878,23.3,1686.6
4487157845,20,5,1,4,5,7,0,0,0,0,15067,6.8,17232,172,56,-1641,-1610,17.2,1506.7,19,4,0,5,4,10,0,0,0,0,16708,7.4,18842,254,52,1641,1610,25.4,1670.8
4526805303,17,4,1,7,7,6,1,0,1,0,16492,6.6,16905,202,32,-499,-295,20.2,1649.2,16,1,0,7,7,10,1,1,0,0,16991,6.8,17200,220,56,499,295,22.0,1699.1
4494944051,13,5,1,3,7,4,0,0,0,0,15392,6.8,17234,240,44,-1445,-694,24.0,1539.2,15,3,0,7,3,9,0,0,0,0,16837,6.8,17928,225,50,1445,694,22.5,1683.7
4519405060,46,0,1,8,3,14,1,1,0,0,17520,7.0,18610,211,55,1892,890,21.1,1752.0,11,2,0,3,8,4,0,0,0,0,15628,6.8,17720,250,52,-1892,-890,25.0,1562.8
4513138341,15,1,0,4,6,5,0,0,0,0,15970,7.0,17837,217,55,-703,-653,21.7,1597.0,22,3,1,6,4,6,1,1,0,0,16673,7.2,18490,221,52,703,653,22.1,1667.3
4503355940,15,1,0,2,4,2,1,1,0,0,14905,6.8,18468,244,56,-1090,522,24.4,1490.5,15,5,1,4,2,4,0,0,0,0,15995,6.8,17946,243,51,1090,-522,24.3,1599.5
4521245361,16,3,1,2,10,1,0,0,0,0,13544,6.2,15367,206,18,-5820,-4066,20.6,1354.4,15,2,0,10,2,8,0,0,0,0,19364,7.2,19433,255,77,5820,4066,25.5,1936.4
4501445520,13,3,0,8,3,7,1,1,0,0,17318,7.4,19714,244,54,2789,3223,24.4,1731.8,15,1,1,3,8,2,0,0,0,0,14529,6.4,16491,203,60,-2789,-3223,20.3,1452.9
4471147482,18,3,0,3,7,4,0,0,0,0,14459,6.6,16596,202,44,-2499,-1870,20.2,1445.9,19,1,1,7,3,13,1,1,0,0,16958,7.0,18466,238,40,2499,1870,23.8,1695.8
4514370002,13,1,0,3,4,5,0,0,0,0,14751,6.8,17562,217,39,-982,36,21.7,1475.1,13,1,1,4,3,6,1,1,0,0,15733,6.8,17526,210,72,982,-36,21.0,1573.3
4499972378,39,4,0,1,5,2,1,1,0,0,14032,6.4,16940,220,53,-1935,-1534,22.0,1403.2,15,3,1,5,1,5,0,0,0,0,15967,7.2,18474,231,45,1935,1534,23.1,1596.7
4518611921,49,3,0,4,10,7,0,0,0,0,14755,6.2,15569,213,39,-4095,-1033,21.3,1475.5,15,0,1,10,4,19,1,1,0,0,18850,6.6,16602,199,56,4095,1033,19.9,1885.0
4496572597,16,3,1,9,4,11,0,0,0,0,17326,7.2,19014,226,44,1132,269,22.6,1732.6,38,3,0,4,9,5,1,1,0,0,16194,7.2,18745,203,59,-1132,-269,20.3,1619.4
4460718392,14,0,0,0,12,0,0,0,0,0,12002,6.0,13961,151,44,-8461,-7340,15.1,1200.2,58,3,1,12,0,9,0,0,0,1,20463,7.8,21301,238,52,8461,7340,23.8,2046.3
4501838629,43,3,1,5,9,2,1,1,0,0,16099,7.0,18159,244,50,-1367,-1526,24.4,1609.9,19,14,0,9,5,9,1,0,1,0,17466,7.4,19685,197,64,1367,1526,19.7,1746.6
4518019885,15,1,0,0,9,0,0,0,0,0,13282,6.4,16226,194,60,-6225,-3975,19.4,1328.2,12,2,1,9,0,9,1,1,0,0,19507,7.4,20201,226,52,6225,3975,22.6,1950.7
4477500359,21,5,0,9,7,7,1,1,0,0,17686,7.0,19734,236,48,1178,2223,23.6,1768.6,41,5,1,7,9,5,1,0,1,0,16508,6.8,17511,187,44,-1178,-2223,18.7,1650.8
4521683040,40,8,1,6,6,14,1,1,0,0,16805,7.0,18793,230,63,11,64,23.0,1680.5,29,4,0,6,6,7,0,0,0,0,16794,7.2,18729,223,56,-11,-64,22.3,1679.4
4508680387,14,3,0,9,9,10,1,1,0,0,17326,6.8,17581,188,50,54,-321,18.8,1732.6,85,0,1,9,9,8,0,0,0,0,17272,6.8,17902,193,44,-54,321,19.3,1727.2
4484490025,16,1,0,5,12,6,0,0,0,0,15782,6.4,16172,195,44,-2707,-2136,19.5,1578.2,19,3,1,12,5,10,1,1,0,0,18489,7.0,18308,233,40,2707,2136,23.3,1848.9
4455218616,14,0,1,11,2,15,0,0,0,0,17395,6.8,17215,170,40,3298,1038,17.0,1739.5,14,4,0,2,11,1,0,0,0,0,14097,6.6,16177,210,44,-3298,-1038,21.0,1409.7
4521299727,35,3,1,13,5,16,0,0,0,0,19452,7.6,20776,212,59,2593,3690,21.2,1945.2,14,3,0,5,13,7,2,1,1,0,16859,6.8,17086,213,64,-2593,-3690,21.3,1685.9
4520971034,17,1,0,12,9,11,1,0,1,0,18325,7.4,19498,190,55,793,1612,19.0,1832.5,10,0,1,9,12,7,1,1,0,0,17532,6.8,17886,208,40,-793,-1612,20.8,1753.2
4521091786,15,0,1,6,9,5,1,0,1,0,16525,6.8,18095,204,47,-1782,-972,20.4,1652.5,18,3,0,9,6,11,1,1,0,0,18307,7.2,19067,217,67,1782,972,21.7,1830.7
4525113077,14,2,0,7,6,10,1,1,0,0,16243,6.8,17548,192,47,-555,-1462,19.2,1624.3,40,2,1,6,7,6,1,0,1,0,16798,7.2,19010,232,64,555,1462,23.2,1679.8
4491135325,20,0,0,8,12,11,0,0,0,0,17540,7.0,17368,182,54,-3563,-1320,18.2,1754.0,16,1,1,12,8,22,1,1,0,0,21103,7.2,18688,198,74,3563,1320,19.8,2110.3
4526104672,21,4,1,8,4,8,2,1,1,0,18230,7.4,20125,246,65,2627,1759,24.6,1823.0,17,6,0,4,8,4,0,0,0,0,15603,7.0,18366,241,52,-2627,-1759,24.1,1560.3
4465670561,35,6,1,13,1,18,1,1,0,0,19641,7.4,19614,207,57,6310,5136,20.7,1964.1,14,1,0,1,13,3,0,0,0,0,13331,6.0,14478,199,40,-6310,-5136,19.9,1333.1
4488919403,15,0,0,5,5,7,0,0,0,0,14469,6.2,15329,136,48,-2579,-3819,13.6,1446.9,14,3,1,5,5,2,1,0,1,0,17048,7.2,19148,244,60,2579,3819,24.4,1704.8
4519816052,16,4,0,7,11,6,1,0,1,0,16446,7.0,18130,218,50,-3620,-282,21.8,1644.6,13,3,1,11,7,16,0,0,0,1,20066,6.8,18412,229,34,3620,282,22.9,2006.6
4519054552,15,4,0,11,4,12,0,0,0,0,18733,7.4,19592,201,62,3925,4105,20.1,1873.3,15,0,1,4,11,9,1,1,0,0,14808,6.4,15487,179,44,-3925,-4105,17.9,1480.8
4508944628,14,3,1,2,5,3,1,1,0,0,15462,7.0,17729,249,66,-1176,-1499,24.9,1546.2,15,1,0,5,2,7,0,0,0,0,16638,7.2,19228,248,58,1176,1499,24.8,1663.8
4457032161,16,4,0,2,3,5,1,1,0,0,14627,6.8,16759,214,64,-1113,-1417,21.4,1462.7,15,6,1,3,2,5,0,0,0,0,15740,7.0,18176,235,68,1113,1417,23.5,1574.0
4523558547,17,3,1,9,6,7,0,0,0,0,17187,7.0,18178,213,40,626,98,21.3,1718.7,14,1,0,6,9,4,0,0,0,0,16561,7.0,18080,231,40,-626,-98,23.1,1656.1
4505709089,42,2,0,7,8,8,1,1,0,0,16122,7.0,17866,186,56,-1782,-308,18.6,1612.2,32,4,1,8,7,10,1,0,1,0,17904,7.0,18174,253,41,1782,308,25.3,1790.4
4519994537,18,1,0,3,7,2,0,0,0,0,14011,6.4,15027,197,33,-4043,-4142,19.7,1401.1,15,1,1,7,3,6,1,1,0,1,18054,7.2,19169,207,51,4043,4142,20.7,1805.4
4497064417,14,2,1,10,1,10,2,1,1,0,19847,7.2,20768,250,64,6658,6189,25.0,1984.7,11,0,0,1,10,2,0,0,0,0,13189,6.2,14579,166,55,-6658,-6189,16.6,1318.9
4502349733,18,3,0,1,2,1,0,0,0,0,13449,6.6,16803,189,48,-1641,-500,18.9,1344.9,14,2,1,2,1,4,0,0,0,0,15090,7.0,17303,224,52,1641,500,22.4,1509.0
4516210841,15,3,1,9,6,17,1,1,0,0,18249,7.0,18327,222,57,1909,-108,22.2,1824.9,22,2,0,6,9,10,0,0,0,0,16340,7.0,18435,231,34,-1909,108,23.1,1634.0
4492897739,14,1,1,7,9,9,0,0,0,0,15888,6.6,15944,195,36,-1696,-2535,19.5,1588.8,11,3,0,9,7,7,0,0,0,0,17584,7.2,18479,186,52,1696,2535,18.6,1758.4
4450023077,19,4,1,4,7,4,0,0,0,0,15407,6.6,16669,223,40,-1207,-2081,22.3,1540.7,19,2,0,7,4,4,0,0,0,0,16614,7.4,18750,226,60,1207,2081,22.6,1661.4
4483111734,13,1,0,3,6,3,0,0,0,0,14647,7.2,17841,185,68,-2084,-851,18.5,1464.7,15,0,1,6,3,6,2,1,1,0,16731,7.0,18692,251,40,2084,851,25.1,1673.1
4459614716,53,6,1,4,3,5,0,0,0,0,16441,7.0,18447,244,52,1254,400,24.4,1644.1,18,3,0,3,4,4,0,0,0,0,15187,6.8,18047,218,60,-1254,-400,21.8,1518.7
4424206558,17,1,1,7,8,10,1,1,0,0,16863,6.6,17727,216,48,106,-462,21.6,1686.3,14,0,0,8,7,9,0,0,0,0,16757,7.2,18189,184,52,-106,462,18.4,1675.7
4492237019,15,2,0,2,3,3,1,1,0,0,15938,7.2,19963,242,72,443,1911,24.2,1593.8,15,2,1,3,2,1,0,0,0,0,15495,7.0,18052,244,56,-443,-1911,24.4,1549.5
4472461570,45,4,0,2,5,2,0,0,0,0,14758,6.8,16974,237,50,-1369,-1808,23.7,1475.8,16,3,1,5,2,2,1,0,1,0,16127,7.2,18782,242,57,1369,1808,24.2,1612.7
4522541214,14,3,0,8,4,8,0,0,0,0,17938,7.2,18237,232,48,3072,1589,23.2,1793.8,15,2,1,4,8,4,1,1,0,0,14866,6.8,16648,207,42,-3072,-1589,20.7,1486.6
4524273849,11,2,1,5,8,5,1,1,0,0,16781,6.6,17452,237,50,633,-295,23.7,1678.1,16,2,0,8,5,13,0,0,0,0,16148,6.8,17747,180,44,-633,295,18.0,1614.8
4501521847,90,3,1,13,5,17,1,1,0,0,18787,7.0,17878,193,40,3886,1777,19.3,1878.7,14,3,0,5,13,5,0,0,0,0,14901,6.6,16101,175,43,-3886,-1777,17.5,1490.1
4523961836,35,0,1,7,6,6,0,0,0,0,17135,7.0,18089,227,46,754,159,22.7,1713.5,16,11,0,6,7,9,0,0,0,0,16381,6.8,17930,195,38,-754,-159,19.5,1638.1
4496503390,33,1,0,2,5,2,0,0,0,0,14935,7.0,17703,230,56,-1208,-152,23.0,1493.5,17,1,1,5,2,8,1,1,0,0,16143,7.0,17855,248,43,1208,152,24.8,1614.3
4523054835,16,6,1,5,4,4,1,1,0,0,15481,6.8,17409,191,65,-253,111,19.1,1548.1,18,2,0,4,5,2,0,0,0,0,15734,6.6,17298,234,55,253,-111,23.4,1573.4
4496024408,12,7,1,4,7,5,0,0,0,0,14703,6.6,16749,232,33,-1323,-591,23.2,1470.3,41,2,0,7,4,15,0,0,0,0,16026,6.8,17340,191,39,1323,591,19.1,1602.6
4508507583,18,2,0,6,4,4,1,0,1,0,16179,6.8,17928,215,52,989,631,21.5,1617.9,24,4,1,4,6,3,0,0,0,0,15190,6.8,17297,212,44,-989,-631,21.2,1519.0
4480350578,18,1,1,7,3,6,0,0,0,0,17082,7.2,19192,224,59,2388,1600,22.4,1708.2,36,2,0,3,7,2,1,1,0,0,14694,7.0,17592,224,49,-2388,-1600,22.4,1469.4
4480995779,15,4,1,11,5,15,0,0,0,0,18106,7.0,17783,191,44,2695,1787,19.1,1810.6,20,1,0,5,11,6,1,1,0,0,15411,6.4,15996,187,52,-2695,-1787,18.7,1541.1
4441973762,15,3,1,13,9,13,1,1,0,1,21908,7.4,20909,227,84,4612,2877,22.7,2190.8,15,1,0,9,13,12,0,0,0,0,17296,7.0,18032,195,44,-4612,-2877,19.5,1729.6
4511553683,15,3,0,7,5,7,1,1,0,0,16424,7.0,17990,205,60,427,479,20.5,1642.4,17,5,1,5,7,4,0,0,0,0,15997,7.0,17511,237,44,-427,-479,23.7,1599.7
4492812373,22,5,0,3,2,1,1,0,1,0,16246,7.2,19387,253,60,2679,3685,25.3,1624.6,13,2,1,2,3,2,1,1,0,0,13567,6.6,15702,169,60,-2679,-3685,16.9,1356.7
4521334344,13,2,1,5,6,4,0,0,0,0,15701,7.0,17899,212,42,-662,-951,21.2,1570.1,14,3,0,6,5,3,2,1,1,0,16363,7.0,18850,243,52,662,951,24.3,1636.3
4477708439,48,0,0,4,5,6,1,1,0,0,15969,7.0,18868,195,72,-876,389,19.5,1596.9,13,2,1,5,4,9,0,0,0,0,16845,7.0,18479,228,63,876,-389,22.8,1684.5
4459701274,18,3,0,1,5,1,1,1,0,0,15364,7.0,18462,233,72,-673,-48,23.3,1536.4,12,3,1,5,1,6,0,0,0,0,16037,7.0,18510,206,48,673,48,20.6,1603.7
4502131494,13,1,0,9,8,17,1,1,0,0,17923,7.0,17698,189,54,-37,-100,18.9,1792.3,14,1,1,8,9,9,0,0,0,0,17960,7.0,17798,202,60,37,100,20.2,1796.0
4494815274,12,0,1,12,6,12,0,0,0,0,18766,7.2,20059,231,45,2265,2656,23.1,1876.6,24,0,0,6,12,6,0,0,0,0,16501,6.8,17403,225,48,-2265,-2656,22.5,1650.1
4527528419,13,6,1,9,2,12,0,0,0,0,17440,7.0,18112,213,36,3422,1091,21.3,1744.0,44,1,0,2,9,1,0,0,0,0,14018,6.8,17021,216,56,-3422,-1091,21.6,1401.8
4509014561,14,13,1,7,1,3,2,1,1,0,16817,7.2,19506,237,64,3021,2386,23.7,1681.7,37,0,0,1,7,0,0,0,0,0,13796,6.8,17120,214,44,-3021,-2386,21.4,1379.6
4520785581,12,2,0,7,8,7,0,0,0,0,16304,6.8,17825,201,51,-28,-63,20.1,1630.4,14,1,1,8,7,4,0,0,0,0,16332,6.8,17888,209,41,28,63,20.9,1633.2
4515259819,137,1,0,0,3,0,1,1,0,0,13610,6.6,16594,199,46,-1817,-1854,19.9,1361.0,18,2,1,3,0,1,0,0,0,0,15427,7.0,18448,238,53,1817,1854,23.8,1542.7
4434549109,41,2,1,3,3,6,1,1,0,0,14623,6.6,15613,173,47,-417,-1234,17.3,1462.3,55,5,0,3,3,4,0,0,0,0,15040,6.8,16847,207,46,417,1234,20.7,1504.0
4476404495,17,2,0,4,7,2,1,1,0,0,15974,6.8,17188,227,48,-836,-839,22.7,1597.4,20,5,1,7,4,10,0,0,0,0,16810,6.8,18027,217,40,836,839,21.7,1681.0
4521217468,42,8,0,5,10,4,1,1,0,0,15876,6.8,17206,224,39,-2266,-2047,22.4,1587.6,20,5,1,10,5,9,1,0,1,0,18142,7.2,19253,221,60,2266,2047,22.1,1814.2
4451402051,21,4,0,1,3,1,1,0,1,0,14672,6.8,17598,247,50,-757,569,24.7,1467.2,19,4,1,3,1,3,1,1,0,0,15429,6.6,17029,242,48,757,-569,24.2,1542.9
4494580681,24,2,1,12,2,13,1,1,0,0,19306,7.4,19450,206,72,5831,4588,20.6,1930.6,19,4,0,2,12,0,0,0,0,0,13475,6.4,14862,197,48,-5831,-4588,19.7,1347.5
4499239181,19,0,0,4,14,5,1,0,1,0,14450,6.4,15560,186,48,-5976,-4619,18.6,1445.0,13,3,1,14,4,14,1,1,0,0,20426,7.4,20179,264,33,5976,4619,26.4,2042.6
4524310829,22,5,1,5,3,6,2,1,1,0,16007,6.8,17370,202,45,701,-628,20.2,1600.7,20,5,0,3,5,2,0,0,0,0,15306,7.0,17998,236,62,-701,628,23.6,1530.6
4525226714,15,5,1,10,5,10,1,1,0,0,18650,7.2,18563,236,44,3028,1818,23.6,1865.0,17,2,0,5,10,4,0,0,0,0,15622,6.8,16745,216,36,-3028,-1818,21.6,1562.2
4506840559,30,3,1,6,4,5,1,1,0,0,16541,6.8,17961,211,51,1568,2039,21.1,1654.1,20,3,0,4,6,5,0,0,0,0,14973,6.6,15922,208,46,-1568,-2039,20.8,1497.3
4516522462,17,1,0,7,10,5,0,0,0,0,16589,7.0,18188,188,57,-3242,-950,18.8,1658.9,14,3,1,10,7,11,1,1,0,1,19831,7.2,19138,253,54,3242,950,25.3,1983.1
4519004936,11,0,1,5,9,2,0,0,0,0,14681,6.8,17137,174,44,-2985,-3019,17.4,1468.1,9,0,0,9,5,8,1,1,0,0,17666,7.6,20156,213,55,2985,3019,21.3,1766.6
4520554639,19,2,1,7,8,5,1,1,0,0,17125,7.2,18785,240,52,449,1210,24.0,1712.5,16,3,0,8,7,13,0,0,0,0,16676,7.0,17575,177,48,-449,-1210,17.7,1667.6
4505357300,16,4,0,6,6,5,0,0,0,0,16029,7.0,18567,205,56,-355,233,20.5,1602.9,19,3,1,6,6,5,1,1,0,0,16384,7.0,18334,224,48,355,-233,22.4,1638.4
4525978244,13,3,0,3,3,5,1,1,0,0,14697,6.6,16968,229,44,-780,-1068,22.9,1469.7,15,2,1,3,3,3,1,0,1,0,15477,7.0,18036,236,59,780,1068,23.6,1547.7
4518235291,14,3,0,6,6,7,1,1,0,0,15814,6.8,17161,205,49,-1530,-922,20.5,1581.4,20,2,1,6,6,6,1,0,1,0,17344,7.0,18083,252,48,1530,922,25.2,1734.4
4499238278,30,3,1,5,5,6,1,0,1,1,18317,7.0,19181,238,60,3006,1814,23.8,1831.7,37,2,0,5,5,5,1,1,0,0,15311,6.8,17367,208,48,-3006,-1814,20.8,1531.1
4526421447,23,1,0,6,8,3,0,0,0,0,16365,6.8,18280,195,71,94,1896,19.5,1636.5,18,3,1,8,6,8,1,1,0,0,16271,6.6,16384,191,50,-94,-1896,19.1,1627.1
4467214068,90,8,0,2,10,2,1,0,1,0,14519,6.8,17122,223,40,-3798,-2950,22.3,1451.9,45,5,1,10,2,13,1,1,0,0,18317,7.4,20072,226,64,3798,2950,22.6,1831.7
4461974957,34,1,0,5,10,5,0,0,0,0,16297,7.2,19135,212,66,-2523,-1057,21.2,1629.7,15,1,1,10,5,10,0,0,0,0,18820,7.4,20192,236,60,2523,1057,23.6,1882.0
4502676809,68,2,1,13,3,19,1,0,1,0,17529,6.8,17038,138,40,1530,-1195,13.8,1752.9,17,5,0,3,13,2,1,1,0,0,15999,6.8,18233,243,63,-1530,1195,24.3,1599.9
4477872277,15,3,1,6,8,8,1,1,0,0,15586,6.8,17198,199,45,-1022,-1301,19.9,1558.6,19,1,0,8,6,7,0,0,0,0,16608,6.8,18499,210,41,1022,1301,21.0,1660.8
4526787106,37,2,1,4,5,4,1,1,0,0,16042,7.0,17865,240,68,-236,711,24.0,1604.2,16,2,0,5,4,8,0,0,0,0,16278,6.8,17154,241,44,236,-711,24.1,1627.8
4495935822,20,4,0,7,5,8,0,0,0,0,16747,6.8,18344,198,40,1058,1735,19.8,1674.7,19,8,1,5,7,9,1,1,0,0,15689,6.6,16609,198,46,-1058,-1735,19.8,1568.9
4417424903,10,0,1,8,6,5,0,0,0,0,16293,7.2,18611,218,44,-176,351,21.8,1629.3,14,3,0,6,8,5,0,0,0,0,16469,7.0,18260,203,56,176,-351,20.3,1646.9
4523810614,16,2,0,5,5,6,1,1,0,0,16253,6.8,18163,212,46,-17,-1171,21.2,1625.3,14,3,1,5,5,2,0,0,0,0,16270,7.2,19334,243,55,17,1171,24.3,1627.0
4458488872,15,0,1,8,6,11,1,1,0,0,16091,6.8,16748,200,44,-765,-492,20.0,1609.1,35,2,0,6,8,11,0,0,0,0,16856,7.0,17240,185,44,765,492,18.5,1685.6
4520915828,16,0,0,13,7,19,1,1,0,0,19609,7.0,17551,207,32,3454,175,20.7,1960.9,13,2,1,7,13,6,0,0,0,0,16155,6.8,17376,201,45,-3454,-175,20.1,1615.5
4519579618,12,2,1,11,7,11,2,1,1,0,17788,7.0,17625,178,50,1655,2014,17.8,1778.8,17,2,0,7,11,12,0,0,0,0,16133,6.4,15611,195,22,-1655,-2014,19.5,1613.3
4518687922,20,4,1,9,3,9,1,1,0,0,17731,7.0,18766,252,55,2748,842,25.2,1773.1,19,2,0,3,9,3,0,0,0,0,14983,7.0,17924,214,52,-2748,-842,21.4,1498.3
4520558243,18,2,1,9,6,7,1,1,0,0,17016,7.2,18560,210,60,338,-232,21.0,1701.6,12,2,0,6,9,7,0,0,0,0,16678,7.0,18792,212,56,-338,232,21.2,1667.8
4523429650,14,2,1,6,7,8,0,0,0,0,17318,7.0,18742,237,72,568,-205,23.7,1731.8,18,1,0,7,6,8,2,1,1,0,16750,7.4,18947,202,60,-568,205,20.2,1675.0
4470033546,12,3,0,3,12,5,0,0,0,0,15978,6.2,15862,192,46,-2818,-3710,19.2,1597.8,17,0,1,12,3,11,1,1,0,0,18796,7.2,19572,211,66,2818,3710,21.1,1879.6
4502643526,34,5,1,2,1,4,0,0,0,0,15379,7.0,18530,238,57,995,1649,23.8,1537.9,12,7,0,1,2,1,0,0,0,0,14384,6.6,16881,232,49,-995,-1649,23.2,1438.4
4526199603,15,3,0,5,15,6,0,0,0,0,15147,6.4,15110,201,33,-4470,-3848,20.1,1514.7,19,0,1,15,5,20,1,1,0,0,19617,7.4,18958,193,50,4470,3848,19.3,1961.7
4523090796,18,3,1,13,3,13,2,1,1,1,19807,6.8,17943,220,36,5227,2051,22.0,1980.7,47,7,0,3,13,1,0,0,0,0,14580,6.6,15892,210,47,-5227,-2051,21.0,1458.0
4524112117,40,1,1,7,4,8,0,0,0,0,15818,6.6,16786,205,36,656,-439,20.5,1581.8,19,3,0,4,7,3,0,0,0,0,15162,6.8,17225,200,53,-656,439,20.0,1516.2
4492030196,19,6,0,5,5,6,0,0,0,0,15943,6.6,17366,229,47,-467,-1361,22.9,1594.3,15,2,1,5,5,5,0,0,0,0,16410,7.0,18727,235,56,467,1361,23.5,1641.0
4519196581,59,4,1,5,9,4,1,1,0,0,15534,6.6,16209,204,40,-2212,-1548,20.4,1553.4,17,4,0,9,5,8,0,0,0,0,17746,6.8,17757,215,60,2212,1548,21.5,1774.6
4491959967,14,0,1,9,9,6,0,0,0,0,17384,6.8,18722,227,48,-898,-939,22.7,1738.4,12,0,0,9,9,9,2,1,1,0,18282,7.2,19661,225,56,898,939,22.5,1828.2
4451696991,35,3,0,11,4,11,1,1,0,0,17596,7.2,19377,203,57,3252,3377,20.3,1759.6,15,4,1,4,11,2,0,0,0,0,14344,6.8,16000,171,54,-3252,-3377,17.1,1434.4
4524227003,16,8,0,3,8,3,1,0,1,0,15330,7.0,18294,230,57,-2105,-1066,23.0,1533.0,24,5,1,8,3,8,1,1,0,0,17435,7.2,19360,225,60,2105,1066,22.5,1743.5
4517035921,17,2,0,6,4,8,1,1,0,0,16623,7.0,18012,243,48,598,-456,24.3,1662.3,16,3,1,4,6,1,1,0,1,0,16025,7.0,18468,224,56,-598,456,22.4,1602.5
4410120147,144,4,1,4,7,6,1,1,0,0,15787,7.2,18200,230,42,-1856,-1804,23.0,1578.7,14,3,0,7,4,11,0,0,0,0,17643,7.4,20004,225,66,1856,1804,22.5,1764.3
4509433346,13,1,1,4,5,5,1,1,0,0,15057,6.8,16805,220,39,-1548,-1574,22.0,1505.7,16,2,0,5,4,4,0,0,0,0,16605,6.8,18379,247,43,1548,1574,24.7,1660.5
4513306375,10,3,0,5,10,7,1,1,0,0,14885,6.4,15463,170,41,-3695,-4018,17.0,1488.5,19,1,1,10,5,8,1,0,1,0,18580,7.2,19481,241,59,3695,4018,24.1,1858.0
4524537915,15,2,0,10,5,8,1,1,0,0,18497,7.2,19069,223,54,3609,3620,22.3,1849.7,13,2,1,5,10,5,0,0,0,0,14888,6.4,15449,174,52,-3609,-3620,17.4,1488.8
4512184541,10,1,1,7,7,5,0,0,0,0,16463,6.8,17576,215,42,-93,-561,21.5,1646.3,33,0,0,7,7,8,1,1,0,0,16556,7.0,18137,217,40,93,561,21.7,1655.6
4451773620,15,2,0,3,3,6,0,0,0,0,15570,6.8,17440,232,36,-339,-1529,23.2,1557.0,20,3,1,3,3,1,2,1,1,0,15909,7.2,18969,244,60,339,1529,24.4,1590.9
4526761574,79,2,0,3,3,2,0,0,0,0,15471,6.8,18349,219,51,-251,560,21.9,1547.1,14,2,1,3,3,7,0,0,0,0,15722,7.0,17789,255,52,251,-560,25.5,1572.2
4496639955,14,3,1,6,6,7,1,1,0,0,16630,7.0,18540,225,48,253,-453,22.5,1663.0,15,3,0,6,6,3,0,0,0,0,16377,7.0,18993,213,56,-253,453,21.3,1637.7
4514076419,20,1,1,4,3,7,0,0,0,0,15711,7.0,17395,223,59,886,706,22.3,1571.1,17,4,0,3,4,4,1,1,0,0,14825,6.8,16689,225,40,-886,-706,22.5,1482.5
4475336164,15,3,1,6,8,6,0,0,0,0,16450,6.6,17381,224,40,-57,-1339,22.4,1645.0,15,3,0,8,6,5,0,0,0,0,16507,7.2,18720,220,44,57,1339,22.0,1650.7
4462777872,16,5,0,12,5,9,0,0,0,0,18279,7.4,18909,174,54,1236,149,17.4,1827.9,15,4,1,5,12,3,2,1,1,0,17043,7.0,18760,224,60,-1236,-149,22.4,1704.3
4527311147,19,0,1,6,8,5,1,1,0,0,17093,7.0,18357,233,48,-414,-601,23.3,1709.3,165,1,0,8,6,7,0,0,0,0,17507,7.2,18958,243,48,414,601,24.3,1750.7
4476291723,12,3,1,4,5,4,0,0,0,0,14538,6.6,16373,211,32,-3278,-1873,21.1,1453.8,19,1,0,5,4,5,1,0,1,1,17816,7.2,18246,255,51,3278,1873,25.5,1781.6
4506294418,17,1,0,2,2,1,0,0,0,0,15831,7.4,19463,271,64,1134,1160,27.1,1583.1,12,3,1,2,2,0,1,1,0,0,14697,7.0,18303,238,61,-1134,-1160,23.8,1469.7
4489438593,15,2,0,8,6,6,0,0,0,0,16947,7.0,18862,184,64,-538,1677,18.4,1694.7,17,2,1,6,8,8,2,1,1,1,17485,6.8,17185,198,47,538,-1677,19.8,1748.5
4519920024,14,3,0,2,5,4,0,0,0,0,13886,6.6,17234,203,45,-2820,-2751,20.3,1388.6,17,3,1,5,2,1,1,1,0,0,16706,7.4,19985,255,72,2820,2751,25.5,1670.6
4527319271,93,1,0,17,4,25,2,1,1,0,21257,7.4,20163,220,48,6713,5380,22.0,2125.7,10,3,1,4,17,3,0,0,0,0,14544,6.2,14783,170,51,-6713,-5380,17.0,1454.4
4504908173,11,1,0,5,14,3,0,0,0,0,15322,6.4,15807,210,56,-4024,-2373,21.0,1532.2,18,2,1,14,5,17,1,1,0,0,19346,6.8,18180,203,47,4024,2373,20.3,1934.6
4513579989,30,4,1,7,10,3,0,0,0,0,16399,7.0,18258,214,44,-1977,-944,21.4,1639.9,13,4,0,10,7,9,0,0,0,0,18376,7.2,19202,231,55,1977,944,23.1,1837.6
4420435152,14,0,0,1,11,0,0,0,0,0,13511,6.6,16013,200,46,-5087,-2795,20.0,1351.1,117,0,1,11,1,18,0,0,0,0,18598,7.2,18808,226,55,5087,2795,22.6,1859.8
4497608843,39,0,1,9,7,8,0,0,0,0,16969,7.0,18552,181,41,416,936,18.1,1696.9,13,3,0,7,9,4,1,1,0,0,16553,6.8,17616,231,42,-416,-936,23.1,1655.3
4476445956,16,2,0,4,11,2,2,1,1,0,14657,6.8,16983,188,59,-3113,-1771,18.8,1465.7,20,1,1,11,4,20,0,0,0,0,17770,7.2,18754,201,45,3113,1771,20.1,1777.0
4454960221,46,3,0,5,12,4,0,0,0,0,16141,7.2,19127,215,52,-3324,-1649,21.5,1614.1,18,2,1,12,5,8,1,1,0,0,19465,7.6,20776,236,58,3324,1649,23.6,1946.5
4488357361,16,5,0,4,8,4,1,0,1,0,15767,7.0,17903,233,52,-953,-677,23.3,1576.7,19,5,1,8,4,8,0,0,0,0,16720,7.0,18580,226,40,953,677,22.6,1672.0
4452824789,34,3,0,2,7,2,0,0,0,0,14135,6.8,17185,220,37,-2711,-2547,22.0,1413.5,13,2,1,7,2,7,0,0,0,0,16846,7.2,19732,230,58,2711,2547,23.0,1684.6
4503353744,13,1,0,2,9,3,1,0,1,0,15325,6.8,17258,238,53,-2368,-250,23.8,1532.5,16,2,1,9,2,14,1,1,0,0,17693,7.0,17508,201,48,2368,250,20.1,1769.3
4526558273,14,1,1,8,9,6,1,1,0,0,16889,6.6,16862,198,52,-696,-1472,19.8,1688.9,15,1,0,9,8,6,0,0,0,0,17585,7.0,18334,201,54,696,1472,20.1,1758.5
4506972533,9,0,1,2,5,3,1,1,0,0,14930,6.8,17328,231,61,-3418,-2689,23.1,1493.0,14,2,0,5,2,3,0,0,0,1,18348,7.4,20017,263,65,3418,2689,26.3,1834.8
4489579352,13,5,1,5,3,5,0,0,0,0,15829,6.8,17771,237,45,968,715,23.7,1582.9,18,2,0,3,5,2,1,1,0,0,14861,6.8,17056,224,44,-968,-715,22.4,1486.1
4523495162,12,2,0,9,11,6,0,0,0,0,17389,6.8,17933,226,36,-1428,-656,22.6,1738.9,15,1,1,11,9,12,1,1,0,0,18817,7.0,18589,237,43,1428,656,23.7,1881.7
4499523222,18,3,0,9,6,14,1,1,0,0,16945,6.8,17806,204,36,1574,761,20.4,1694.5,17,2,1,6,9,6,0,0,0,0,15371,6.8,17045,194,54,-1574,-761,19.4,1537.1
4494412133,16,0,1,10,4,10,1,0,1,1,19598,7.0,18704,242,44,4864,1938,24.2,1959.8,15,4,0,4,10,5,0,0,0,0,14734,6.8,16766,204,44,-4864,-1938,20.4,1473.4
4512919782,45,3,1,7,6,10,0,0,0,0,16275,6.8,16968,190,56,495,21,19.0,1627.5,20,0,0,6,7,10,0,0,0,0,15780,6.8,16947,197,48,-495,-21,19.7,1578.0
4459678917,13,1,0,4,7,7,0,0,0,0,15520,6.8,18045,199,72,-2195,-291,19.9,1552.0,14,3,1,7,4,8,0,0,0,0,17715,7.0,18336,255,48,2195,291,25.5,1771.5
4484950651,18,3,1,10,0,8,0,0,0,0,18408,7.4,19945,243,52,5041,3633,24.3,1840.8,15,3,0,0,10,0,0,0,0,0,13367,6.6,16312,202,57,-5041,-3633,20.2,1336.7
4483653964,71,1,0,6,10,7,1,1,0,0,16832,6.8,17641,222,60,-1467,-1504,22.2,1683.2,15,1,1,10,6,12,0,0,0,0,18299,7.4,19145,210,64,1467,1504,21.0,1829.9
4524058240,41,3,0,1,6,2,1,1,0,0,14165,6.8,17829,218,59,-1963,-45,21.8,1416.5,19,2,1,6,1,7,0,0,0,0,16128,7.0,17874,205,52,1963,45,20.5,1612.8
4487337497,13,1,1,6,5,9,1,1,0,0,16995,7.0,18679,230,64,930,567,23.0,1699.5,18,2,0,5,6,3,0,0,0,0,16065,7.0,18112,221,43,-930,-567,22.1,1606.5
4518050394,44,3,1,3,3,3,0,0,0,0,15081,6.8,17777,206,50,-66,815,20.6,1508.1,16,3,0,3,3,6,0,0,0,0,15147,7.0,16962,215,45,66,-815,21.5,1514.7
4526272276,15,2,0,1,6,1,0,0,0,0,13409,6.6,15601,203,45,-3559,-3320,20.3,1340.9,12,1,1,6,1,4,2,1,1,0,16968,7.0,18921,236,69,3559,3320,23.6,1696.8
4524546153,16,6,1,5,5,5,0,0,0,0,16051,6.8,16995,235,48,-290,-1061,23.5,1605.1,17,6,0,5,5,7,1,1,0,0,16341,6.8,18056,245,35,290,1061,24.5,1634.1
4429486916,18,2,1,9,5,9,0,0,0,0,17941,7.2,19379,230,51,2187,2189,23.0,1794.1,45,3,0,5,9,5,0,0,0,0,15754,7.0,17190,206,52,-2187,-2189,20.6,1575.4
4523593666,16,1,0,5,13,3,1,1,0,0,15151,6.6,16565,204,56,-4570,-3352,20.4,1515.1,33,0,1,13,5,18,1,0,1,0,19721,7.4,19917,207,68,4570,3352,20.7,1972.1
4441849412,17,1,0,4,5,4,0,0,0,0,15218,7.0,19074,203,52,-1911,-1211,20.3,1521.8,15,1,1,5,4,7,2,1,1,0,17129,7.4,20285,250,68,1911,1211,25.0,1712.9
4494910229,13,2,1,4,6,8,0,0,0,0,16135,6.6,16458,213,52,173,461,21.3,1613.5,18,0,0,6,4,11,1,1,0,0,15962,6.4,15997,196,52,-173,-461,19.6,1596.2
4512610035,14,3,0,4,9,3,1,1,0,0,15533,7.0,18431,214,56,-3728,-2079,21.4,1553.3,16,4,1,9,4,8,0,0,0,0,19261,7.4,20510,259,65,3728,2079,25.9,1926.1
4524378471,16,5,0,11,10,10,1,1,0,0,18720,7.2,18913,222,44,-438,-669,22.2,1872.0,37,1,1,10,11,12,0,0,0,0,19158,7.2,19582,186,64,438,669,18.6,1915.8
4523421831,11,4,1,4,4,7,1,1,0,0,15788,6.8,18264,243,50,671,881,24.3,1578.8,17,0,0,4,4,5,0,0,0,0,15117,7.0,17383,228,48,-671,-881,22.8,1511.7
4518753838,14,1,1,5,3,5,0,0,0,0,15892,6.8,18043,216,48,822,25,21.6,1589.2,13,1,0,3,5,3,2,1,1,0,15070,7.2,18018,229,55,-822,-25,22.9,1507.0
4521641335,45,3,1,13,7,13,1,0,1,0,18022,6.8,17168,182,36,1643,2462,18.2,1802.2,17,2,0,7,13,6,1,1,0,1,16379,6.2,14706,153,46,-1643,-2462,15.3,1637.9
4521311431,19,0,1,6,7,5,0,0,0,0,16217,6.8,17326,217,41,112,79,21.7,1621.7,14,4,0,7,6,8,2,1,1,0,16105,6.8,17247,225,43,-112,-79,22.5,1610.5
4506388090,12,5,0,3,12,2,1,0,1,0,15111,6.8,17710,210,68,-3620,-2690,21.0,1511.1,17,4,1,12,3,9,1,1,0,0,18731,7.2,20400,236,45,3620,2690,23.6,1873.1
4525163715,36,6,0,2,12,2,0,0,0,0,13802,6.8,17008,202,52,-5571,-2139,20.2,1380.2,18,20,1,12,2,16,2,1,1,0,19373,7.2,19147,247,48,5571,2139,24.7,1937.3
4526206684,19,1,0,5,6,3,0,0,0,0,15580,6.6,17286,197,44,-502,-1113,19.7,1558.0,13,2,1,6,5,4,1,0,1,0,16082,7.2,18399,197,55,502,1113,19.7,1608.2
4518881307,17,2,0,3,7,5,0,0,0,0,14676,6.6,16668,170,59,-1563,-1232,17.0,1467.6,18,1,1,7,3,3,1,1,0,0,16239,6.8,17900,201,52,1563,1232,20.1,1623.9
4413539086,23,4,1,11,9,12,1,0,1,1,19858,7.4,19501,216,54,3335,2786,21.6,1985.8,17,3,0,9,11,12,1,1,0,0,16523,6.4,16715,168,46,-3335,-2786,16.8,1652.3
4442569713,16,4,1,10,5,8,1,1,0,0,18633,6.8,18488,231,44,4235,3554,23.1,1863.3,15,3,0,5,10,4,0,0,0,0,14398,6.2,14934,164,48,-4235,-3554,16.4,1439.8
4495670658,18,3,0,6,3,8,1,1,0,0,17146,7.2,18930,219,60,2326,1907,21.9,1714.6,14,0,1,3,6,2,0,0,0,0,14820,6.6,17023,206,59,-2326,-1907,20.6,1482.0
4520884097,16,2,0,8,8,7,1,1,0,0,17664,7.0,19310,220,60,257,1665,22.0,1766.4,15,2,1,8,8,11,1,0,1,0,17407,6.8,17645,225,56,-257,-1665,22.5,1740.7
4511067003,12,4,0,4,10,2,0,0,0,0,16956,7.2,19562,252,81,-387,1466,25.2,1695.6,16,2,1,10,4,11,1,1,0,0,17343,7.0,18096,236,44,387,-1466,23.6,1734.3
4505404755,13,1,0,4,4,5,1,1,0,0,15398,6.8,17802,200,60,-893,771,20.0,1539.8,15,2,1,4,4,4,0,0,0,1,16291,6.8,17031,212,36,893,-771,21.2,1629.1
4484729770,16,3,0,5,7,6,0,0,0,0,16043,6.8,17403,237,38,-689,-1668,23.7,1604.3,18,2,1,7,5,5,1,1,0,0,16732,7.0,19071,231,57,689,1668,23.1,1673.2
4523653027,19,3,1,5,4,7,0,0,0,0,16989,7.0,18031,256,60,2000,1065,25.6,1698.9,16,4,0,4,5,7,1,1,0,0,14989,6.8,16966,206,51,-2000,-1065,20.6,1498.9
4409386215,25,1,1,4,3,4,0,0,0,0,15838,6.8,18368,221,62,-348,-901,22.1,1583.8,17,4,0,3,4,4,1,1,0,0,16186,7.2,19269,261,66,348,901,26.1,1618.6
4508293000,13,5,0,3,5,2,0,0,0,0,14761,7.0,17479,204,64,-907,414,20.4,1476.1,16,2,1,5,3,6,1,1,0,0,15668,6.6,17065,225,46,907,-414,22.5,1566.8
4524520097,14,1,0,0,6,0,0,0,0,0,13421,6.6,17265,221,52,-3543,-1737,22.1,1342.1,13,2,1,6,0,7,1,1,0,0,16964,7.2,19002,242,48,3543,1737,24.2,1696.4
4515203264,15,2,0,6,5,11,1,1,0,0,16452,6.8,17946,208,60,906,1330,20.8,1645.2,16,1,1,5,6,7,0,0,0,0,15546,6.6,16616,185,43,-906,-1330,18.5,1554.6
4508511932,14,3,1,2,8,2,0,0,0,0,14904,6.6,15958,222,50,-1302,-1959,22.2,1490.4,19,5,0,8,2,6,2,1,1,0,16206,7.0,17917,194,50,1302,1959,19.4,1620.6
4526130313,25,1,0,2,3,2,1,0,1,0,13703,6.8,16964,187,48,-1912,-957,18.7,1370.3,13,2,1,3,2,0,0,0,0,0,15615,7.0,17921,241,56,1912,957,24.1,1561.5
4515771570,15,1,0,3,4,4,0,0,0,0,15022,7.0,18105,220,48,-1211,-108,22.0,1502.2,17,1,1,4,3,5,0,0,0,0,16233,6.8,18213,216,67,1211,108,21.6,1623.3
4492269154,15,3,0,7,7,12,0,0,0,0,17329,6.8,17342,212,60,216,259,21.2,1732.9,49,2,1,7,7,12,0,0,0,0,17113,6.8,17083,181,52,-216,-259,18.1,1711.3
4484501357,17,3,0,1,5,3,0,0,0,0,14463,6.8,18394,224,68,-2820,-1048,22.4,1446.3,18,2,1,5,1,8,1,1,0,0,17283,7.4,19442,258,68,2820,1048,25.8,1728.3
4523384060,11,1,1,3,4,1,0,0,0,0,15336,7.0,17953,253,43,-761,-10,25.3,1533.6,14,1,0,4,3,5,1,0,1,0,16097,6.8,17963,219,52,761,10,21.9,1609.7
4420577274,17,5,1,5,5,7,1,0,1,0,16242,7.0,18244,235,56,-598,-146,23.5,1624.2,24,2,0,5,5,11,1,1,0,0,16840,7.0,18390,229,59,598,146,22.9,1684.0
4500030602,12,1,1,6,11,8,1,1,0,0,15855,6.8,17383,204,48,-2536,-2343,20.4,1585.5,13,0,0,11,6,11,0,0,0,0,18391,7.0,19726,218,48,2536,2343,21.8,1839.1
4519807061,18,3,0,12,4,16,1,1,0,0,19726,7.4,19180,246,48,5020,3785,24.6,1972.6,13,2,1,4,12,6,0,0,0,0,14706,6.4,15395,192,48,-5020,-3785,19.2,1470.6
4470658458,14,4,0,8,4,8,1,0,1,0,17349,7.6,19375,197,55,1942,1658,19.7,1734.9,19,3,1,4,8,2,1,1,0,0,15407,6.8,17717,228,52,-1942,-1658,22.8,1540.7
4523516940,16,3,1,5,7,4,0,0,0,0,15866,6.6,16957,222,51,-635,-2299,22.2,1586.6,15,1,0,7,5,5,1,1,0,0,16501,7.2,19256,215,56,635,2299,21.5,1650.1
4519324641,34,0,1,13,5,12,1,1,0,0,19535,7.4,19835,231,53,4778,4324,23.1,1953.5,17,2,0,5,13,5,0,0,0,0,14757,6.2,15511,173,51,-4778,-4324,17.3,1475.7
4515297257,14,7,0,3,6,4,0,0,0,0,15227,7.0,17701,231,59,-1558,-1782,23.1,1522.7,20,3,1,6,3,6,2,1,1,0,16785,7.0,19483,244,44,1558,1782,24.4,1678.5
4526164537,17,2,0,4,8,4,0,0,0,0,14434,6.6,15829,183,40,-4603,-2667,18.3,1443.4,17,4,1,8,4,11,2,1,1,1,19037,7.0,18496,212,48,4603,2667,21.2,1903.7
4525851788,12,2,1,6,5,9,1,0,1,0,17025,6.8,17699,207,56,1128,-45,20.7,1702.5,17,1,0,5,6,4,1,1,0,0,15897,7.0,17744,226,52,-1128,45,22.6,1589.7
4474739496,15,5,1,8,4,10,1,1,0,0,17640,7.0,18174,207,55,4035,3311,20.7,1764.0,51,3,0,4,8,9,0,0,0,0,13605,6.0,14863,155,40,-4035,-3311,15.5,1360.5
4495025348,13,2,0,8,7,4,2,1,1,0,17683,7.6,20153,237,56,1289,2602,23.7,1768.3,16,2,1,7,8,7,0,0,0,0,16394,6.6,17551,208,36,-1289,-2602,20.8,1639.4
4519770095,9,2,1,10,10,11,2,1,1,1,19556,7.2,18530,198,53,2100,1556,19.8,1955.6,16,2,0,10,10,11,0,0,0,0,17456,6.8,16974,189,47,-2100,-1556,18.9,1745.6
4465424033,13,4,1,4,12,3,1,0,1,0,15140,6.6,15933,198,48,-4199,-3415,19.8,1514.0,23,2,0,12,4,11,0,0,0,1,19339,7.2,19348,221,40,4199,3415,22.1,1933.9
4521375330,15,1,0,5,4,4,0,0,0,0,15387,6.6,16280,196,41,-501,-934,19.6,1538.7,18,5,1,4,5,3,0,0,0,0,15888,6.6,17214,210,46,501,934,21.0,1588.8
4516204235,18,2,0,5,4,7,1,0,1,0,16104,7.0,17890,231,48,1039,589,23.1,1610.4,16,5,1,4,5,3,1,1,0,0,15065,6.8,17301,205,47,-1039,-589,20.5,1506.5
4527015583,14,1,0,6,11,4,0,0,0,0,15775,6.8,17025,206,44,-2861,-1651,20.6,1577.5,17,1,1,11,6,14,1,1,0,0,18636,7.0,18676,210,52,2861,1651,21.0,1863.6
4517015396,16,5,1,6,6,10,0,0,0,0,16992,6.8,17775,227,53,1182,420,22.7,1699.2,20,2,0,6,6,8,0,0,0,0,15810,6.6,17355,203,39,-1182,-420,20.3,1581.0
4468293476,25,1,1,3,3,4,0,0,0,0,15834,7.0,18253,248,52,324,-574,24.8,1583.4,9,2,0,3,3,3,2,1,1,0,15510,7.2,18827,220,68,-324,574,22.0,1551.0
4515730845,18,2,1,6,4,5,0,0,0,0,15895,6.8,17705,225,48,-1018,-1531,22.5,1589.5,15,3,0,4,6,6,1,1,0,0,16913,7.4,19236,232,80,1018,1531,23.2,1691.3
4524932837,17,3,1,9,1,9,1,1,0,0,17079,7.0,17962,229,44,3916,2599,22.9,1707.9,16,0,0,1,9,0,0,0,0,0,13163,6.6,15363,191,44,-3916,-2599,19.1,1316.3
4505960953,16,3,0,10,7,12,0,0,0,0,17839,7.0,18614,201,48,1452,689,20.1,1783.9,39,1,1,7,10,5,1,1,0,0,16387,7.2,17925,198,56,-1452,-689,19.8,1638.7
4521004120,17,2,1,5,7,1,0,0,0,0,15446,6.6,16681,183,62,-1257,-1406,18.3,1544.6,86,1,0,7,5,5,1,1,0,0,16703,6.8,18087,186,56,1257,1406,18.6,1670.3
4467978443,18,3,0,7,6,10,1,0,1,0,15948,6.6,16134,185,39,-361,-1022,18.5,1594.8,19,2,1,6,7,7,0,0,0,0,16309,6.8,17156,196,44,361,1022,19.6,1630.9
4439674846,41,2,1,5,6,3,1,0,1,1,17389,7.4,19074,224,53,760,120,22.4,1738.9,13,3,0,6,5,6,1,1,0,0,16629,7.2,18954,235,57,-760,-120,23.5,1662.9
4509926355,16,1,0,5,9,4,1,0,1,0,15539,6.4,16163,163,50,-1337,-1246,16.3,1553.9,18,2,1,9,5,9,0,0,0,0,16876,7.0,17409,190,42,1337,1246,19.0,1687.6
4524326952,19,0,0,9,6,9,0,0,0,0,17368,6.8,18134,219,40,280,-1018,21.9,1736.8,15,3,1,6,9,8,0,0,0,0,17088,7.2,19152,227,59,-280,1018,22.7,1708.8
4524145810,17,6,1,10,8,12,1,1,0,0,17756,7.0,18320,201,40,-145,-28,20.1,1775.6,21,3,0,8,10,5,0,0,0,0,17901,7.0,18348,219,59,145,28,21.9,1790.1
4439417196,19,5,1,8,5,9,1,1,0,0,17389,6.8,18252,198,57,836,883,19.8,1738.9,17,3,0,5,8,10,0,0,0,0,16553,6.6,17369,237,56,-836,-883,23.7,1655.3
4512168503,18,4,0,4,7,3,2,1,1,0,15210,6.8,17099,185,72,-2630,-2244,18.5,1521.0,19,4,1,7,4,6,0,0,0,0,17840,7.2,19343,222,71,2630,2244,22.2,1784.0
4526645317,12,2,0,3,7,5,0,0,0,0,15521,7.0,17703,210,63,-1079,233,21.0,1552.1,48,1,1,7,3,14,1,1,0,0,16600,7.0,17470,215,44,1079,-233,21.5,1660.0
4471725979,14,1,1,5,6,4,1,0,1,0,15307,6.8,16772,205,47,-1618,-1224,20.5,1530.7,13,2,0,6,5,9,0,0,0,0,16925,7.0,17996,243,36,1618,1224,24.3,1692.5
4503039394,39,3,1,7,3,11,0,0,0,0,16879,7.4,19019,237,43,2336,2323,23.7,1687.9,13,0,0,3,7,3,0,0,0,0,14543,6.8,16696,194,51,-2336,-2323,19.4,1454.3
4527648336,38,6,1,9,5,7,0,0,0,0,16940,7.2,18098,203,36,893,256,20.3,1694.0,19,16,0,5,9,5,1,1,0,0,16047,7.0,17842,228,48,-893,-256,22.8,1604.7
4421907838,30,2,1,7,3,7,1,0,1,0,17622,7.2,19582,230,64,3071,2643,23.0,1762.2,20,3,0,3,7,4,0,0,0,0,14551,6.6,16939,220,36,-3071,-2643,22.0,1455.1
4478222063,18,3,0,7,5,9,0,0,0,0,16518,6.6,17024,202,44,238,275,20.2,1651.8,147,3,1,5,7,9,0,0,0,0,16280,6.6,16749,210,42,-238,-275,21.0,1628.0
4522792360,30,6,1,5,5,7,1,0,1,0,16804,6.8,17544,217,67,769,480,21.7,1680.4,16,4,0,5,5,6,1,1,0,0,16035,6.4,17064,233,54,-769,-480,23.3,1603.5
4519250621,14,7,1,5,6,4,0,0,0,0,15693,6.8,17493,230,48,-1285,-2097,23.0,1569.3,39,3,0,6,5,7,2,1,1,0,16978,7.4,19590,236,58,1285,2097,23.6,1697.8
4526080128,17,1,1,11,3,10,0,0,0,0,18092,7.0,18652,213,43,4024,2465,21.3,1809.2,14,1,0,3,11,1,1,1,0,0,14068,6.2,16187,212,40,-4024,-2465,21.2,1406.8
4492027887,17,2,0,8,11,6,1,0,1,0,15941,6.8,16613,180,37,-2440,-1603,18.0,1594.1,14,5,1,11,8,15,0,0,0,0,18381,6.8,18216,219,40,2440,1603,21.9,1838.1
4492577817,14,4,1,3,9,2,1,1,0,0,13769,6.2,15094,174,54,-4147,-3023,17.4,1376.9,16,4,0,9,3,7,0,0,0,0,17916,7.0,18117,217,48,4147,3023,21.7,1791.6
4471508213,15,5,1,9,0,10,1,1,0,0,18258,7.4,19948,237,67,4535,3490,23.7,1825.8,15,3,0,0,9,0,0,0,0,0,13723,6.6,16458,237,50,-4535,-3490,23.7,1372.3
4524823620,51,5,1,8,5,13,0,0,0,0,17663,6.8,18440,202,60,1942,890,20.2,1766.3,39,2,0,5,8,3,1,0,1,0,15721,6.8,17550,205,58,-1942,-890,20.5,1572.1
4510127229,16,4,1,10,5,14,0,0,0,0,18538,7.2,19030,247,44,1806,632,24.7,1853.8,16,2,0,5,10,5,1,1,0,0,16732,7.0,18398,216,64,-1806,-632,21.6,1673.2
4518072555,16,5,0,8,5,10,1,1,0,0,17513,7.0,18498,234,44,834,861,23.4,1751.3,26,1,1,5,8,7,0,0,0,0,16679,6.8,17637,215,60,-834,-861,21.5,1667.9
4524290277,26,2,1,7,7,5,1,1,0,0,17400,7.4,19175,239,64,567,-8,23.9,1740.0,67,0,0,7,7,10,0,0,0,0,16833,7.2,19183,237,56,-567,8,23.7,1683.3
4450359024,9,1,0,2,9,2,0,0,0,0,14953,6.8,17850,228,52,-3084,-1719,22.8,1495.3,15,3,1,9,2,9,1,1,0,0,18037,7.4,19569,258,56,3084,1719,25.8,1803.7
4508360116,37,3,1,6,5,7,1,1,0,0,16149,7.0,18253,217,44,-549,-323,21.7,1614.9,15,3,0,5,6,5,0,0,0,0,16698,6.8,18576,233,59,549,323,23.3,1669.8
4480526985,17,2,1,6,3,6,0,0,0,0,17186,7.0,18505,234,68,2320,2234,23.4,1718.6,17,2,0,3,6,6,0,0,0,0,14866,6.6,16271,207,44,-2320,-2234,20.7,1486.6
4526832449,15,3,1,7,9,9,1,0,1,1,17655,6.4,16585,203,52,-134,-1518,20.3,1765.5,16,2,0,9,7,16,1,1,0,0,17789,7.0,18103,217,53,134,1518,21.7,1778.9
4523305351,16,6,0,5,4,6,1,0,1,0,16033,6.8,17303,211,51,1073,103,21.1,1603.3,17,2,1,4,5,2,1,1,0,0,14960,6.8,17200,225,50,-1073,-103,22.5,1496.0
4513799193,14,1,0,2,4,3,1,1,0,0,14318,7.0,17405,207,51,-2928,-110,20.7,1431.8,17,4,1,4,2,10,0,0,0,1,17246,7.0,17515,240,44,2928,110,24.0,1724.6
4520653758,14,1,1,6,7,11,0,0,0,0,15844,6.8,16801,197,47,-151,-895,19.7,1584.4,17,0,0,7,6,5,2,1,1,0,15995,6.8,17696,205,60,151,895,20.5,1599.5
4527444282,13,2,0,3,9,2,1,1,0,0,13876,6.6,16521,175,47,-3248,-1706,17.5,1387.6,46,1,1,9,3,8,0,0,0,0,17124,7.0,18227,194,52,3248,1706,19.4,1712.4
4511234219,13,1,0,4,9,8,0,0,0,0,17071,6.8,17610,205,48,-1763,-2184,20.5,1707.1,13,2,1,9,4,10,1,1,0,0,18834,7.4,19794,236,56,1763,2184,23.6,1883.4
4513831840,16,1,1,6,6,7,0,0,0,0,16784,7.0,17848,228,40,941,129,22.8,1678.4,16,1,0,6,6,4,0,0,0,0,15843,6.8,17719,176,55,-941,-129,17.6,1584.3
4445240846,16,2,0,7,5,6,1,1,0,0,16304,6.8,17968,230,43,0,845,23.0,1630.4,15,3,1,5,7,8,0,0,0,0,16304,6.6,17123,234,44,0,-845,23.4,1630.4
4526085370,21,5,1,12,6,8,1,1,0,0,18432,7.2,19560,224,41,2495,3183,22.4,1843.2,19,2,0,6,12,8,0,0,0,0,15937,6.8,16377,193,52,-2495,-3183,19.3,1593.7
4526952901,12,7,1,6,5,3,2,1,1,1,17948,7.0,18736,247,48,2435,894,24.7,1794.8,18,1,0,5,6,7,0,0,0,0,15513,6.8,17842,219,35,-2435,-894,21.9,1551.3
4445701647,74,3,0,10,7,9,1,0,1,0,18209,7.2,18851,209,50,2343,2878,20.9,1820.9,17,3,1,7,10,8,1,1,0,0,15866,6.4,15973,170,54,-2343,-2878,17.0,1586.6
4473786370,19,4,0,4,4,6,1,1,0,0,15867,6.6,17723,186,71,-1595,-1648,18.6,1586.7,21,1,1,4,4,4,0,0,0,0,17462,7.2,19371,253,64,1595,1648,25.3,1746.2
4483620406,19,2,0,3,6,1,1,0,1,0,14499,7.0,18406,201,68,-3079,-1816,20.1,1449.9,13,4,1,6,3,4,1,1,0,0,17578,7.2,20222,245,63,3079,1816,24.5,1757.8
4515973150,57,4,0,3,6,4,0,0,0,0,15426,7.2,18766,212,79,-1672,-470,21.2,1542.6,60,9,1,6,3,6,1,1,0,0,17098,7.2,19236,259,56,1672,470,25.9,1709.8
4519672552,29,3,0,9,7,10,0,0,0,0,17126,6.8,17604,195,52,1386,679,19.5,1712.6,18,2,1,7,9,4,1,1,0,0,15740,6.6,16925,202,48,-1386,-679,20.2,1574.0
4521542696,13,0,1,9,4,6,0,0,0,0,18189,7.0,19191,220,54,3905,3713,22.0,1818.9,15,3,0,4,9,3,0,0,0,0,14284,6.2,15478,181,52,-3905,-3713,18.1,1428.4
4502001730,25,4,0,11,6,12,0,0,0,0,19537,7.0,18358,189,60,2718,1185,18.9,1953.7,20,1,1,6,11,8,1,1,0,0,16819,7.0,17173,211,48,-2718,-1185,21.1,1681.9
4519229802,21,5,0,3,8,1,0,0,0,0,14269,6.6,16844,200,48,-3145,-2166,20.0,1426.9,19,5,1,8,3,10,1,1,0,0,17414,7.2,19010,235,53,3145,2166,23.5,1741.4
4446051712,10,4,0,3,10,3,0,0,0,0,15548,6.8,17564,215,44,-2686,-2037,21.5,1554.8,184,1,1,10,3,15,1,1,0,0,18234,7.4,19601,212,43,2686,2037,21.2,1823.4
4524641094,37,3,0,8,5,13,0,0,0,0,17129,6.8,17579,227,32,1192,449,22.7,1712.9,15,3,1,5,8,7,0,0,0,0,15937,6.8,17130,225,48,-1192,-449,22.5,1593.7
4496960681,21,8,0,1,12,1,0,0,0,0,13525,6.4,15625,210,46,-5423,-4119,21.0,1352.5,39,6,1,12,1,14,1,1,0,0,18948,7.4,19744,206,46,5423,4119,20.6,1894.8
4484453587,15,1,0,4,5,4,0,0,0,0,15161,7.0,17998,194,72,-786,-837,19.4,1516.1,16,2,1,5,4,3,1,1,0,0,15947,7.2,18835,231,55,786,837,23.1,1594.7
4505305847,17,7,1,9,7,7,1,1,0,0,16466,6.6,16716,188,44,-1099,-1318,18.8,1646.6,46,7,0,7,9,7,0,0,0,0,17565,7.0,18034,232,40,1099,1318,23.2,1756.5
4510883651,18,0,1,6,11,5,0,0,0,0,15246,6.4,15419,151,42,-4370,-4504,15.1,1524.6,16,5,0,11,6,12,1,1,0,0,19616,7.2,19923,235,51,4370,4504,23.5,1961.6
4509682522,13,1,0,2,6,1,0,0,0,0,14804,7.0,17613,239,44,-1645,-1076,23.9,1480.4,28,1,1,6,2,7,1,1,0,0,16449,6.8,18689,245,47,1645,1076,24.5,1644.9
4448427323,14,1,1,15,3,5,0,0,0,0,19038,7.2,19801,261,32,4941,4702,26.1,1903.8,17,2,0,3,15,5,0,0,0,0,14097,6.2,15099,190,48,-4941,-4702,19.0,1409.7
4516034199,12,4,0,2,8,2,1,1,0,0,15421,7.2,19276,217,84,-2771,-1125,21.7,1542.1,14,2,1,8,2,5,0,0,0,0,18192,7.4,20401,234,64,2771,1125,23.4,1819.2
4491456543,20,5,1,10,1,15,1,1,0,0,18795,7.4,20241,260,43,4498,3370,26.0,1879.5,22,3,0,1,10,2,0,0,0,0,14297,6.4,16871,226,48,-4498,-3370,22.6,1429.7
4521458621,105,2,0,3,8,2,0,0,0,0,14533,6.8,17818,198,56,-4033,-1850,19.8,1453.3,14,2,1,8,3,9,1,1,0,0,18566,7.2,19668,220,64,4033,1850,22.0,1856.6
4522594325,15,0,1,11,5,13,0,0,0,1,19979,7.2,18500,207,39,3763,874,20.7,1997.9,11,1,0,5,11,6,0,0,0,0,16216,7.0,17626,194,51,-3763,-874,19.4,1621.6
4473969390,16,6,1,4,16,5,0,0,0,0,14813,6.0,14354,198,20,-5062,-5699,19.8,1481.3,21,7,0,16,4,22,2,1,1,0,19875,7.4,20053,250,45,5062,5699,25.0,1987.5
4499960219,17,3,1,10,6,13,2,1,1,1,19263,7.4,19347,197,50,3840,3165,19.7,1926.3,21,3,0,6,10,8,0,0,0,0,15423,6.4,16182,204,38,-3840,-3165,20.4,1542.3
4516146115,37,2,0,6,8,4,0,0,0,0,16051,6.8,17315,199,58,-485,-353,19.9,1605.1,18,1,1,8,6,8,1,1,0,0,16536,6.8,17668,199,44,485,353,19.9,1653.6
4500741087,18,3,0,3,15,3,0,0,0,0,14878,6.6,16826,197,61,-5924,-3368,19.7,1487.8,17,5,1,15,3,20,2,1,1,0,20802,7.2,20194,226,64,5924,3368,22.6,2080.2
4520324538,16,0,0,7,7,11,1,1,0,0,17162,7.2,18810,216,56,-810,123,21.6,1716.2,19,5,1,7,7,10,0,0,0,0,17972,7.2,18687,272,47,810,-123,27.2,1797.2
4521001903,17,2,0,6,4,7,1,1,0,0,16057,7.0,17977,231,44,172,-278,23.1,1605.7,16,2,1,4,6,7,1,0,1,0,15885,7.0,18255,242,56,-172,278,24.2,1588.5
4525216073,18,1,0,6,2,7,1,1,0,0,17062,7.2,20216,235,64,2436,2608,23.5,1706.2,12,5,1,2,6,3,1,0,1,0,14626,7.0,17608,203,60,-2436,-2608,20.3,1462.6
4522505411,14,16,0,3,9,2,0,0,0,0,14539,6.4,16806,213,40,-3900,-3550,21.3,1453.9,42,2,1,9,3,8,1,1,0,0,18439,7.6,20356,255,51,3900,3550,25.5,1843.9
4512800157,17,5,1,10,9,9,1,1,0,0,18531,7.2,18550,217,44,1492,-676,21.7,1853.1,19,7,0,9,10,4,0,0,0,0,17039,7.0,19226,214,56,-1492,676,21.4,1703.9
4387774615,15,3,0,3,4,1,0,0,0,0,14205,7.0,18034,197,50,-1099,-396,19.7,1420.5,12,3,1,4,3,4,1,1,0,0,15304,7.0,18430,236,43,1099,396,23.6,1530.4
4518203153,21,7,0,6,4,8,0,0,0,0,15840,6.8,16689,204,48,-376,-1118,20.4,1584.0,19,5,1,4,6,4,0,0,0,0,16216,6.8,17807,228,43,376,1118,22.8,1621.6
4483263508,80,1,0,1,7,1,0,0,0,0,14400,6.4,16399,215,43,-2884,-3321,21.5,1440.0,35,0,1,7,1,5,1,1,0,0,17284,7.2,19720,239,66,2884,3321,23.9,1728.4
4498508859,15,0,1,9,6,15,0,0,0,0,18847,7.0,19097,218,68,2197,233,21.8,1884.7,15,2,0,6,9,8,1,1,0,0,16650,7.4,18864,236,44,-2197,-233,23.6,1665.0
4516037651,47,1,0,7,5,5,0,0,0,0,16089,6.8,17265,198,45,-490,-217,19.8,1608.9,17,0,1,5,7,4,1,1,0,0,16579,6.8,17482,229,57,490,217,22.9,1657.9
4448198434,14,2,0,6,1,7,0,0,0,0,17666,7.2,20014,264,63,3749,3555,26.4,1766.6,16,4,1,1,6,1,0,0,0,0,13917,6.4,16459,214,47,-3749,-3555,21.4,1391.7
4456782548,42,0,0,9,10,14,0,0,0,0,17215,6.8,17349,198,31,-1908,-994,19.8,1721.5,16,2,1,10,9,11,0,0,0,0,19123,7.2,18343,235,55,1908,994,23.5,1912.3
4436906182,13,1,1,4,6,5,0,0,0,0,15420,6.8,16822,235,41,-1633,-2918,23.5,1542.0,17,2,0,6,4,5,1,0,1,0,17053,7.4,19740,253,52,1633,2918,25.3,1705.3
4466740420,24,3,0,4,4,7,1,1,0,0,15222,6.6,16755,207,51,7,-685,20.7,1522.2,19,2,1,4,4,4,0,0,0,0,15215,6.8,17440,212,52,-7,685,21.2,1521.5
4492589905,48,2,0,1,3,1,1,1,0,0,15119,6.8,18281,249,64,-326,-294,24.9,1511.9,13,0,1,3,1,3,1,0,1,0,15445,7.4,18575,228,53,326,294,22.8,1544.5
4497981317,15,0,1,8,9,5,0,0,0,0,16319,6.8,17715,217,32,-1228,11,21.7,1631.9,11,1,0,9,8,9,0,0,0,0,17547,6.8,17704,191,47,1228,-11,19.1,1754.7
4496739291,16,3,1,10,5,7,1,1,0,0,18240,7.0,19116,259,31,2953,1980,25.9,1824.0,17,2,0,5,10,4,0,0,0,0,15287,6.8,17136,197,64,-2953,-1980,19.7,1528.7
4485980330,15,6,0,2,6,2,0,0,0,0,16241,7.2,18365,236,57,250,942,23.6,1624.1,38,0,1,6,2,8,1,1,0,0,15991,6.8,17423,196,56,-250,-942,19.6,1599.1
4463266834,14,3,0,6,6,10,1,1,0,0,16701,7.0,17762,196,56,-16,-467,19.6,1670.1,17,1,1,6,6,3,0,0,0,0,16717,7.2,18229,232,47,16,467,23.2,1671.7
4445877402,16,2,1,10,4,9,1,0,1,0,17933,7.2,19728,217,52,2690,2444,21.7,1793.3,14,2,0,4,10,6,1,1,0,0,15243,6.8,17284,213,56,-2690,-2444,21.3,1524.3
4500531155,35,6,1,5,4,6,1,1,0,0,16516,7.2,19033,224,52,1115,1256,22.4,1651.6,39,2,0,4,5,3,0,0,0,0,15401,7.2,17777,209,60,-1115,-1256,20.9,1540.1
4524966850,10,2,1,9,6,8,0,0,0,0,16396,6.6,17294,168,56,975,659,16.8,1639.6,19,0,0,6,9,4,0,0,0,0,15421,6.6,16635,191,48,-975,-659,19.1,1542.1
4520419730,18,2,1,5,6,5,2,1,1,0,16635,7.4,19221,235,76,152,-57,23.5,1663.5,37,3,0,6,5,10,0,0,0,0,16483,7.4,19278,233,40,-152,57,23.3,1648.3
4517495714,18,3,0,3,7,3,0,0,0,0,15355,6.6,17119,204,43,-2215,-2114,20.4,1535.5,16,2,1,7,3,8,2,1,1,0,17570,7.2,19233,240,65,2215,2114,24.0,1757.0
4509706108,16,18,1,4,11,3,0,0,0,0,14958,6.6,16928,184,42,-5089,-4890,18.4,1495.8,53,1,0,11,4,7,1,0,1,1,20047,7.8,21818,243,63,5089,4890,24.3,2004.7
4522601125,19,1,1,7,3,12,2,1,1,0,17791,7.2,18557,250,48,2763,1017,25.0,1779.1,16,3,0,3,7,5,0,0,0,0,15028,6.8,17540,200,55,-2763,-1017,20.0,1502.8
4524577264,16,5,0,4,5,7,0,0,0,0,15820,7.0,18001,242,58,-758,-392,24.2,1582.0,16,3,1,5,4,4,2,1,1,0,16578,7.2,18393,229,52,758,392,22.9,1657.8
4500995168,15,2,0,8,9,11,1,1,0,0,17592,6.8,17635,214,52,-134,-565,21.4,1759.2,18,3,1,9,8,10,0,0,0,0,17726,7.0,18200,221,45,134,565,22.1,1772.6
4523545639,18,1,1,9,8,15,0,0,0,0,18809,7.0,18415,225,39,2309,1211,22.5,1880.9,15,1,0,8,9,8,1,1,0,0,16500,7.0,17204,185,55,-2309,-1211,18.5,1650.0
4452913051,19,1,1,6,3,6,2,1,1,0,17201,6.8,17943,186,67,2184,419,18.6,1720.1,48,3,0,3,6,4,0,0,0,0,15017,6.8,17524,211,52,-2184,-419,21.1,1501.7
4483304287,92,3,0,6,4,7,1,1,0,0,16541,7.0,19056,249,44,1294,1165,24.9,1654.1,13,1,1,4,6,6,0,0,0,0,15247,7.0,17891,211,50,-1294,-1165,21.1,1524.7
4484030443,13,0,0,5,13,3,0,0,0,0,14910,6.4,16295,198,40,-4644,-3580,19.8,1491.0,13,2,1,13,5,13,0,0,0,0,19554,7.4,19875,247,46,4644,3580,24.7,1955.4
4519715253,50,1,1,7,1,5,0,0,0,1,18193,7.0,18289,225,52,4939,2073,22.5,1819.3,193,0,0,1,7,0,0,0,0,0,13254,6.6,16216,175,66,-4939,-2073,17.5,1325.4
4514036288,15,4,1,4,9,2,0,0,0,0,14887,6.4,15841,209,38,-3088,-2028,20.9,1488.7,17,2,0,9,4,12,0,0,0,0,17975,6.8,17869,203,39,3088,2028,20.3,1797.5
4500469260,12,2,0,4,7,3,0,0,0,0,15473,6.8,17491,215,61,-1093,-449,21.5,1547.3,14,0,1,7,4,7,1,1,0,0,16566,7.0,17940,236,39,1093,449,23.6,1656.6
4522571135,42,5,1,8,6,11,1,1,0,0,17072,7.2,18825,205,42,-164,851,20.5,1707.2,13,6,0,6,8,8,1,0,1,0,17236,7.0,17974,244,45,164,-851,24.4,1723.6
4527042510,20,1,1,12,4,14,2,1,1,0,19339,7.2,19966,225,66,3708,2901,22.5,1933.9,83,3,0,4,12,3,0,0,0,0,15631,6.8,17065,203,60,-3708,-2901,20.3,1563.1
4515599821,16,1,0,6,10,5,0,0,0,0,15985,7.0,17976,176,52,-2993,-2498,17.6,1598.5,15,1,1,10,6,7,2,1,1,0,18978,7.4,20474,218,58,2993,2498,21.8,1897.8
4469549199,15,2,1,3,1,3,1,1,0,0,15243,6.6,17194,224,56,830,-1002,22.4,1524.3,40,4,0,1,3,1,1,0,1,0,14413,6.8,18196,220,56,-830,1002,22.0,1441.3
4479510893,49,2,1,8,8,14,0,0,0,0,17346,6.8,16570,191,41,1399,1293,19.1,1734.6,21,5,0,8,8,14,0,0,0,0,15947,6.2,15277,193,34,-1399,-1293,19.3,1594.7
4525597127,18,2,0,3,3,4,1,1,0,0,15008,7.0,18344,211,56,-37,1144,21.1,1500.8,17,3,1,3,3,3,0,0,0,0,15045,6.8,17200,221,47,37,-1144,22.1,1504.5
4512191521,14,1,0,3,6,4,0,0,0,0,15057,6.8,17267,218,64,-3443,-1347,21.8,1505.7,16,3,1,6,3,10,1,1,0,1,18500,7.2,18614,219,68,3443,1347,21.9,1850.0
4481260961,15,2,0,5,5,5,0,0,0,0,15552,7.0,16960,211,44,726,-512,21.1,1555.2,16,3,1,5,5,3,1,1,0,0,14826,6.8,17472,192,42,-726,512,19.2,1482.6
4503813130,15,0,1,7,8,3,0,0,0,0,16058,7.0,17194,200,49,-535,1397,20.0,1605.8,14,1,0,8,7,5,1,1,0,0,16593,6.6,15797,198,40,535,-1397,19.8,1659.3
4521413190,15,5,0,7,3,4,1,1,0,0,16616,7.2,19895,246,43,958,2603,24.6,1661.6,20,0,1,3,7,5,0,0,0,0,15658,6.8,17292,229,48,-958,-2603,22.9,1565.8
4381068813,42,1,1,7,3,8,1,1,0,0,16146,6.6,16204,196,43,2037,-281,19.6,1614.6,19,5,0,3,7,3,0,0,0,0,14109,6.4,16485,172,57,-2037,281,17.2,1410.9
4526256395,37,3,0,1,6,1,1,0,1,0,14308,6.8,17611,235,48,-2634,-1282,23.5,1430.8,19,3,1,6,1,9,1,1,0,0,16942,7.4,18893,247,66,2634,1282,24.7,1694.2
4523449093,26,1,0,6,6,5,2,1,1,0,15539,6.8,17101,191,56,8,572,19.1,1553.9,17,2,1,6,6,8,0,0,0,0,15531,6.4,16529,208,48,-8,-572,20.8,1553.1
4481808559,16,1,1,4,6,2,0,0,0,0,16463,7.2,18904,247,71,801,1090,24.7,1646.3,10,0,0,6,4,7,1,1,0,0,15662,6.8,17814,197,60,-801,-1090,19.7,1566.2
4521615656,14,0,0,7,4,4,1,1,0,0,16775,7.0,18235,221,55,1753,2303,22.1,1677.5,19,3,1,4,7,7,0,0,0,0,15022,6.4,15932,213,45,-1753,-2303,21.3,1502.2
4500743979,13,2,0,2,10,1,0,0,0,0,14227,6.6,16822,205,44,-2617,-2322,20.5,1422.7,15,1,1,10,2,11,1,1,0,0,16844,7.2,19144,208,40,2617,2322,20.8,1684.4
4513917134,79,4,1,8,6,7,0,0,0,0,17809,7.0,18479,238,48,2278,2211,23.8,1780.9,15,3,0,6,8,8,0,0,0,0,15531,6.4,16268,189,44,-2278,-2211,18.9,1553.1
4523400286,24,2,0,3,3,4,0,0,0,0,14940,6.6,16977,238,44,-1131,-1921,23.8,1494.0,40,12,1,3,3,2,0,0,0,0,16071,7.0,18898,247,68,1131,1921,24.7,1607.1
4488299127,14,1,0,2,12,3,0,0,0,0,14579,6.4,15758,196,52,-4225,-2478,19.6,1457.9,10,4,1,12,2,16,0,0,0,0,18804,7.2,18236,230,32,4225,2478,23.0,1880.4
4515532917,15,6,1,3,5,5,0,0,0,0,14378,6.4,16230,209,39,-3682,-3599,20.9,1437.8,14,3,0,5,3,2,2,1,1,1,18060,7.4,19829,245,66,3682,3599,24.5,1806.0
4499336831,14,0,1,10,9,8,0,0,0,0,17817,6.8,17747,188,40,780,74,18.8,1781.7,12,3,0,9,10,7,0,0,0,0,17037,7.0,17673,212,44,-780,-74,21.2,1703.7
4522556160,23,3,0,4,6,5,0,0,0,0,16467,7.2,18715,261,56,-530,-123,26.1,1646.7,19,3,1,6,4,8,1,1,0,0,16997,7.0,18838,227,64,530,123,22.7,1699.7
4481415061,10,1,0,6,14,3,0,0,0,0,16142,6.8,16953,198,59,-3109,-1745,19.8,1614.2,13,1,1,14,6,16,2,1,1,0,19251,7.0,18698,201,37,3109,1745,20.1,1925.1
4525072110,89,2,1,13,4,13,1,0,1,0,19569,7.2,19298,203,36,5148,2308,20.3,1956.9,42,4,0,4,13,2,1,1,0,0,14421,6.8,16990,179,51,-5148,-2308,17.9,1442.1
4512764436,29,2,1,6,2,8,0,0,0,0,16523,7.0,18018,196,60,1652,701,19.6,1652.3,14,1,0,2,6,1,0,0,0,0,14871,6.4,17317,239,51,-1652,-701,23.9,1487.1
4513818469,15,1,0,4,8,8,0,0,0,0,15503,6.8,18406,204,52,-2892,-2716,20.4,1550.3,14,1,1,8,4,6,2,1,1,0,18395,7.6,21122,261,72,2892,2716,26.1,1839.5
4477019326,10,3,0,5,5,7,0,0,0,0,16038,7.2,19227,228,54,-844,139,22.8,1603.8,14,3,1,5,5,5,1,1,0,0,16882,7.2,19088,226,68,844,-139,22.6,1688.2
4475799088,20,0,0,8,12,9,0,0,0,0,16830,7.0,17100,206,59,-1619,265,20.6,1683.0,21,4,1,12,8,19,1,0,1,0,18449,7.0,16835,158,45,1619,-265,15.8,1844.9
4453662166,13,3,0,8,7,9,0,0,0,0,16973,7.0,18421,204,46,929,1800,20.4,1697.3,17,4,1,7,8,4,0,0,0,0,16044,6.8,16621,203,48,-929,-1800,20.3,1604.4
4500962702,18,2,0,6,2,8,2,1,1,0,16814,7.2,18759,231,59,1519,1104,23.1,1681.4,17,0,1,2,6,2,0,0,0,0,15295,7.0,17655,234,52,-1519,-1104,23.4,1529.5
4524261959,16,3,0,5,10,5,0,0,0,0,15491,6.4,15893,194,45,-2183,-2010,19.4,1549.1,20,3,1,10,5,6,0,0,0,0,17674,6.8,17903,224,35,2183,2010,22.4,1767.4
4506796397,14,1,0,4,2,4,1,1,0,0,15346,7.0,18388,232,52,1342,1886,23.2,1534.6,14,0,1,2,4,2,0,0,0,0,14004,6.6,16502,206,40,-1342,-1886,20.6,1400.4
4524796098,41,3,1,2,3,0,0,0,0,0,14312,6.8,17694,216,52,-980,-684,21.6,1431.2,17,3,0,3,2,0,0,0,0,0,15292,7.0,18378,236,52,980,684,23.6,1529.2
4524569254,13,3,0,9,5,4,2,1,1,0,18434,7.4,20263,223,70,2812,2497,22.3,1843.4,16,2,1,5,9,3,0,0,0,0,15622,7.2,17766,226,55,-2812,-2497,22.6,1562.2
4524703970,14,3,0,2,9,2,0,0,0,0,13545,6.4,15716,180,51,-4868,-4160,18.0,1354.5,16,1,1,9,2,12,1,1,0,0,18413,7.4,19876,242,47,4868,4160,24.2,1841.3
4521490447,84,1,1,8,5,8,1,0,1,0,17473,7.0,18577,228,48,1179,-736,22.8,1747.3,38,1,0,5,8,5,0,0,0,0,16294,7.4,19313,225,52,-1179,736,22.5,1629.4
4525247260,18,9,1,9,1,13,1,1,0,0,17461,7.2,18412,235,48,3119,896,23.5,1746.1,44,2,0,1,9,1,1,0,1,0,14342,7.0,17516,228,56,-3119,-896,22.8,1434.2
4469567856,16,2,1,6,7,3,2,1,1,0,16308,7.0,18718,227,65,-52,430,22.7,1630.8,14,2,0,7,6,5,0,0,0,0,16360,7.2,18288,208,52,52,-430,20.8,1636.0
4524603410,15,1,1,8,7,6,1,1,0,0,17850,7.2,19943,238,71,1097,1914,23.8,1785.0,16,2,0,7,8,6,0,0,0,0,16753,7.0,18029,224,40,-1097,-1914,22.4,1675.3
4513636712,18,2,0,3,11,1,0,0,0,0,13602,6.4,15564,170,44,-5088,-2609,17.0,1360.2,13,3,1,11,3,16,1,1,0,0,18690,7.2,18173,231,48,5088,2609,23.1,1869.0
4477165590,15,0,0,3,5,3,0,0,0,0,15767,7.2,18720,233,56,-943,140,23.3,1576.7,14,4,1,5,3,5,1,1,0,0,16710,7.2,18580,249,48,943,-140,24.9,1671.0
4450770211,17,7,0,8,9,13,1,1,0,0,17579,7.2,18266,224,41,475,1006,22.4,1757.9,22,2,1,9,8,10,0,0,0,0,17104,6.8,17260,205,36,-475,-1006,20.5,1710.4
4526920856,25,1,0,4,5,3,1,1,0,0,15791,7.0,18218,220,56,-478,346,22.0,1579.1,17,2,1,5,4,4,0,0,0,0,16269,7.0,17872,247,42,478,-346,24.7,1626.9
4432091797,86,4,1,3,5,3,0,0,0,0,14754,6.6,17158,186,62,-1342,-1966,18.6,1475.4,36,6,0,5,3,6,1,1,0,0,16096,7.2,19124,218,54,1342,1966,21.8,1609.6
4476146291,88,2,1,10,2,6,1,1,0,0,19077,7.6,20483,234,52,5271,3997,23.4,1907.7,15,1,0,2,10,2,0,0,0,0,13806,6.6,16486,191,48,-5271,-3997,19.1,1380.6
4456261396,70,2,1,8,3,8,1,1,0,0,17166,7.4,20100,208,63,2027,2259,20.8,1716.6,13,4,0,3,8,1,0,0,0,0,15139,6.8,17841,218,48,-2027,-2259,21.8,1513.9
4522252175,18,4,1,8,9,7,0,0,0,0,17336,7.2,19025,218,60,691,696,21.8,1733.6,20,4,0,9,8,7,0,0,0,0,16645,7.0,18329,192,40,-691,-696,19.2,1664.5
4472496029,15,2,1,6,6,5,1,1,0,0,15414,6.4,16960,188,43,-2545,-761,18.8,1541.4,17,2,0,6,6,5,1,0,1,1,17959,6.8,17721,225,51,2545,761,22.5,1795.9
4520362775,18,2,0,11,9,16,0,0,0,0,18557,7.2,18792,192,44,524,478,19.2,1855.7,17,1,1,9,11,7,1,1,0,0,18033,7.0,18314,213,48,-524,-478,21.3,1803.3
4516451603,17,2,1,12,5,17,1,1,0,0,18685,6.8,18421,234,44,2857,1406,23.4,1868.5,12,4,0,5,12,4,0,0,0,0,15828,6.8,17015,214,48,-2857,-1406,21.4,1582.8
4497277699,21,1,1,1,4,2,0,0,0,0,14270,6.6,16394,230,43,-1103,-2692,23.0,1427.0,14,3,0,4,1,3,1,1,0,0,15373,7.0,19086,244,52,1103,2692,24.4,1537.3
4521067380,20,3,0,4,10,2,1,1,0,0,14843,6.4,16207,176,45,-2691,-1778,17.6,1484.3,14,3,1,10,4,12,1,0,1,0,17534,7.2,17985,199,52,2691,1778,19.9,1753.4
4526224124,12,6,1,8,2,8,1,1,0,0,18477,7.2,19589,248,51,3593,1136,24.8,1847.7,19,1,0,2,8,0,0,0,0,0,14884,7.0,18453,236,64,-3593,-1136,23.6,1488.4
4478567807,18,2,0,2,7,2,0,0,0,0,14857,6.4,16453,210,59,-1726,-1890,21.0,1485.7,15,1,1,7,2,17,1,1,0,0,16583,7.2,18343,203,44,1726,1890,20.3,1658.3
4516719935,13,2,0,2,4,2,1,1,0,0,15312,7.0,18210,250,61,-961,-725,25.0,1531.2,16,4,1,4,2,3,0,0,0,0,16273,7.2,18935,250,56,961,725,25.0,1627.3
4496346599,19,3,0,6,8,9,1,1,0,0,15731,6.8,17396,236,37,-2238,-1138,23.6,1573.1,17,2,1,8,6,8,0,0,0,0,17969,7.2,18534,235,65,2238,1138,23.5,1796.9
4518577355,15,3,1,10,5,9,1,1,0,0,19265,7.4,20085,244,75,4692,3644,24.4,1926.5,16,1,0,5,10,0,0,0,0,0,14573,6.6,16441,221,28,-4692,-3644,22.1,1457.3
4521939526,13,3,0,1,7,0,0,0,0,0,13828,6.6,16964,228,53,-3588,-2501,22.8,1382.8,17,2,1,7,1,6,0,0,0,0,17416,7.2,19465,258,60,3588,2501,25.8,1741.6
4454250539,35,2,0,11,7,14,0,0,0,0,19106,6.8,17739,189,60,2013,900,18.9,1910.6,17,1,1,7,11,8,0,0,0,0,17093,6.6,16839,188,47,-2013,-900,18.8,1709.3
4454214561,11,1,1,7,9,6,0,0,0,0,16248,7.0,18067,171,63,-2242,-1819,17.1,1624.8,33,2,0,9,7,12,1,1,0,0,18490,7.2,19886,229,45,2242,1819,22.9,1849.0
4523838498,14,1,0,4,8,4,2,1,1,0,14312,6.6,16196,144,57,-2861,-2348,14.4,1431.2,55,3,1,8,4,12,0,0,0,0,17173,7.2,18544,217,56,2861,2348,21.7,1717.3
4486168054,23,1,1,5,11,6,0,0,0,0,15696,6.6,16453,195,42,-2942,-1785,19.5,1569.6,17,7,0,11,5,14,0,0,0,0,18638,7.0,18238,212,47,2942,1785,21.2,1863.8
4487058187,16,4,1,9,1,9,1,1,0,0,17239,7.2,19459,232,46,3497,3543,23.2,1723.9,16,1,0,1,9,2,0,0,0,0,13742,6.4,15916,223,53,-3497,-3543,22.3,1374.2
4527544639,50,1,0,8,9,8,0,0,0,0,15372,6.8,16833,161,40,-3616,-3352,16.1,1537.2,12,2,1,9,8,4,1,1,0,0,18988,7.6,20185,248,64,3616,3352,24.8,1898.8
4526234314,18,3,0,7,7,9,1,1,0,0,16136,6.4,16071,212,47,436,-475,21.2,1613.6,18,5,1,7,7,6,0,0,0,0,15700,6.8,16546,190,42,-436,475,19.0,1570.0
4525051331,15,5,0,8,4,12,1,1,0,0,17306,6.8,18073,237,43,2170,1383,23.7,1730.6,14,2,1,4,8,5,0,0,0,0,15136,6.4,16690,218,44,-2170,-1383,21.8,1513.6
4516355012,14,1,1,8,12,5,1,0,1,0,16093,7.0,16927,154,53,-3195,-953,15.4,1609.3,12,2,0,12,8,13,0,0,0,0,19288,6.8,17880,213,46,3195,953,21.3,1928.8
4395598976,12,3,1,4,9,5,0,0,0,0,14420,6.4,15196,192,32,-2519,-1095,19.2,1442.0,18,3,0,9,4,15,0,0,0,0,16939,6.4,16291,194,46,2519,1095,19.4,1693.9
4525037711,18,4,1,3,4,2,1,0,1,0,15888,7.4,19090,252,60,16,433,25.2,1588.8,39,4,0,4,3,2,1,1,0,0,15872,7.0,18657,243,49,-16,-433,24.3,1587.2
4479366531,36,0,1,3,2,4,0,0,0,0,15751,7.0,18853,252,56,991,1570,25.2,1575.1,18,3,0,2,3,2,0,0,0,0,14760,6.8,17283,222,56,-991,-1570,22.2,1476.0
4500614731,39,3,0,3,5,3,0,0,0,0,15610,7.2,19049,246,57,-99,727,24.6,1561.0,16,1,1,5,3,7,0,0,0,0,15709,6.8,18322,234,48,99,-727,23.4,1570.9
4520017267,10,2,1,8,12,8,0,0,0,0,17237,7.0,18392,213,41,-1133,-714,21.3,1723.7,57,0,0,12,8,12,1,1,0,0,18370,7.4,19106,196,46,1133,714,19.6,1837.0
4520670087,18,0,0,10,4,6,0,0,0,0,17125,7.0,17861,210,40,1294,453,21.0,1712.5,14,3,1,4,10,3,1,1,0,0,15831,7.0,17408,223,56,-1294,-453,22.3,1583.1
4526183369,22,4,1,10,8,17,1,1,0,0,18828,7.2,18186,197,53,2117,180,19.7,1882.8,16,4,0,8,10,8,1,0,1,0,16711,6.8,18006,209,47,-2117,-180,20.9,1671.1
4513249754,16,2,1,13,8,20,1,0,1,2,21728,7.4,20117,242,62,4161,2591,24.2,2172.8,10,2,0,8,13,15,0,0,0,0,17567,6.8,17526,214,58,-4161,-2591,21.4,1756.7
4505237084,15,2,1,5,4,4,0,0,0,0,15742,6.8,17504,219,55,501,642,21.9,1574.2,13,1,0,4,5,5,1,1,0,0,15241,6.6,16862,196,52,-501,-642,19.6,1524.1
4507610115,16,2,1,6,0,7,0,0,0,0,16144,7.0,18236,199,49,1594,477,19.9,1614.4,37,2,0,0,6,0,1,1,0,0,14550,7.0,17759,257,60,-1594,-477,25.7,1455.0
4478269360,12,2,1,1,6,1,0,0,0,0,14598,6.6,17033,217,69,-2286,-2574,21.7,1459.8,13,3,0,6,1,9,1,1,0,0,16884,7.2,19607,227,68,2286,2574,22.7,1688.4
4461218405,16,2,1,11,4,9,1,1,0,0,19612,7.6,20290,259,50,4871,2019,25.9,1961.2,14,3,0,4,11,1,0,0,0,0,14741,7.0,18271,210,53,-4871,-2019,21.0,1474.1
4471530570,20,3,0,8,9,7,2,1,1,0,17299,7.0,18331,218,48,-1143,-1447,21.8,1729.9,16,7,1,9,8,6,0,0,0,0,18442,7.2,19778,233,60,1143,1447,23.3,1844.2
4500293065,17,5,0,6,1,12,1,1,0,0,16009,6.8,17605,194,51,685,333,19.4,1600.9,17,1,1,1,6,0,0,0,0,0,15324,6.6,17272,252,72,-685,-333,25.2,1532.4
4518590112,18,0,0,5,7,6,0,0,0,0,15470,6.8,17038,217,40,-1708,-677,21.7,1547.0,51,2,1,7,5,12,0,0,0,0,17178,7.2,17715,207,44,1708,677,20.7,1717.8
4524963082,13,3,0,2,7,2,0,0,0,0,13825,6.6,15977,185,51,-2891,-3196,18.5,1382.5,16,0,1,7,2,7,0,0,0,0,16716,7.4,19173,229,53,2891,3196,22.9,1671.6
4513442197,12,5,0,10,12,7,0,0,0,0,17431,6.8,17722,202,48,-1294,-267,20.2,1743.1,17,2,1,12,10,20,0,0,0,0,18725,6.8,17989,195,65,1294,267,19.5,1872.5
4527034667,17,2,0,8,5,10,1,0,1,0,17812,7.0,19113,234,41,2554,2046,23.4,1781.2,13,3,1,5,8,4,1,1,0,0,15258,6.6,17067,212,35,-2554,-2046,21.2,1525.8
4523506086,17,2,0,1,3,1,0,0,0,0,14735,7.0,18220,234,63,-665,-337,23.4,1473.5,47,5,1,3,1,3,1,1,0,0,15400,7.0,18557,227,65,665,337,22.7,1540.0
4522501943,17,3,1,7,6,8,0,0,0,0,16533,7.0,17850,198,60,-727,-675,19.8,1653.3,15,1,0,6,7,7,1,1,0,0,17260,7.0,18525,224,60,727,675,22.4,1726.0
4478911331,14,4,0,12,5,23,1,1,0,0,18494,6.8,17736,212,43,3098,2685,21.2,1849.4,25,1,1,5,12,9,0,0,0,0,15396,6.2,15051,188,34,-3098,-2685,18.8,1539.6
4464530205,16,5,0,5,8,5,0,0,0,0,15649,7.0,17079,201,51,-934,-732,20.1,1564.9,17,4,1,8,5,11,1,1,0,0,16583,6.8,17811,216,48,934,732,21.6,1658.3
4489726898,15,1,1,3,0,3,1,1,0,0,15429,6.8,18375,218,64,1453,1251,21.8,1542.9,12,1,0,0,3,0,0,0,0,0,13976,6.6,17124,231,64,-1453,-1251,23.1,1397.6
4495332793,12,0,0,2,3,2,1,0,1,0,14191,6.8,16725,207,48,-1093,-1572,20.7,1419.1,119,1,1,3,2,3,0,0,0,0,15284,7.2,18297,239,55,1093,1572,23.9,1528.4
4513310043,18,7,1,7,8,3,0,0,0,0,16863,6.8,17725,206,42,783,-301,20.6,1686.3,18,5,0,8,7,7,1,1,0,0,16080,7.0,18026,186,44,-783,301,18.6,1608.0
4521693404,14,2,1,5,2,6,1,0,1,0,17511,7.4,20020,253,59,2795,2702,25.3,1751.1,12,2,0,2,5,2,1,1,0,0,14716,7.0,17318,244,52,-2795,-2702,24.4,1471.6
4412400770,35,4,1,8,5,7,2,1,1,0,16712,6.8,17310,208,41,2427,2303,20.8,1671.2,12,2,0,5,8,7,0,0,0,0,14285,6.4,15007,172,33,-2427,-2303,17.2,1428.5
4513928992,15,4,0,5,7,10,1,0,1,0,15735,6.6,17073,225,47,-488,-237,22.5,1573.5,19,3,1,7,5,8,1,1,0,0,16223,6.8,17310,200,48,488,237,20.0,1622.3
4506183108,15,2,0,4,8,4,1,1,0,0,15290,6.6,17203,219,55,-2387,-2353,21.9,1529.0,17,3,1,8,4,6,0,0,0,0,17677,7.4,19556,242,48,2387,2353,24.2,1767.7
4493201984,17,5,1,3,1,4,1,0,1,0,16247,7.0,19000,257,56,1351,940,25.7,1624.7,25,3,0,1,3,0,1,1,0,0,14896,7.0,18060,269,60,-1351,-940,26.9,1489.6
4469830896,15,7,0,6,7,7,1,1,0,0,16517,6.8,16913,238,44,-409,-2098,23.8,1651.7,18,4,1,7,6,7,1,0,1,0,16926,7.0,19011,254,44,409,2098,25.4,1692.6
4517546735,85,6,1,9,1,11,1,1,0,0,18824,7.2,19996,237,59,5240,2335,23.7,1882.4,20,2,0,1,9,0,0,0,0,0,13584,7.0,17661,217,42,-5240,-2335,21.7,1358.4
4465445670,14,4,1,9,1,5,0,0,0,0,17773,7.2,18937,236,46,4257,2902,23.6,1777.3,14,3,0,1,9,1,0,0,0,0,13516,6.4,16035,204,53,-4257,-2902,20.4,1351.6
4526649785,14,1,0,7,6,7,1,1,0,0,16553,7.2,19304,205,56,1216,2889,20.5,1655.3,11,2,1,6,7,7,0,0,0,0,15337,6.6,16415,173,44,-1216,-2889,17.3,1533.7
4523432190,41,1,1,3,7,4,0,0,0,0,15715,7.0,18159,246,54,-1235,-956,24.6,1571.5,17,17,0,7,3,4,1,1,0,0,16950,7.2,19115,252,52,1235,956,25.2,1695.0
4466191823,15,6,0,8,4,9,1,1,0,0,16804,7.2,18899,206,60,2290,1865,20.6,1680.4,10,2,1,4,8,2,0,0,0,0,14514,6.6,17034,180,40,-2290,-1865,18.0,1451.4
4424203287,19,1,1,13,6,13,0,0,0,0,18901,7.2,19110,244,36,2972,1799,24.4,1890.1,14,2,0,6,13,4,0,0,0,0,15929,6.8,17311,206,52,-2972,-1799,20.6,1592.9
4464085930,30,0,1,9,9,9,0,0,0,0,17658,7.0,17546,214,47,108,-88,21.4,1765.8,16,2,0,9,9,8,1,0,1,0,17550,7.0,17634,235,36,-108,88,23.5,1755.0
4520641645,25,3,0,6,1,8,1,1,0,0,16129,7.2,18567,210,48,2279,2842,21.0,1612.9,17,2,1,1,6,1,0,0,0,0,13850,6.4,15725,205,39,-2279,-2842,20.5,1385.0
4512351336,60,8,0,5,8,9,0,0,0,0,15966,7.0,18157,209,47,-847,-267,20.9,1596.6,55,3,1,8,5,8,1,1,0,0,16813,7.2,18424,203,60,847,267,20.3,1681.3
4492130975,18,0,0,4,3,5,0,0,0,0,14769,6.8,17725,215,36,-1071,-843,21.5,1476.9,10,2,1,3,4,2,0,0,0,0,15840,7.0,18568,242,51,1071,843,24.2,1584.0
4492498778,46,1,0,8,11,7,0,0,0,0,17917,7.2,19033,234,55,39,-27,23.4,1791.7,30,2,1,11,8,13,1,1,0,0,17878,7.2,19060,180,59,-39,27,18.0,1787.8
4524469798,46,3,0,8,6,14,0,0,0,0,16898,7.2,18746,213,48,734,1966,21.3,1689.8,13,1,1,6,8,9,0,0,0,0,16164,6.4,16780,209,44,-734,-1966,20.9,1616.4
4489658562,12,2,1,10,16,10,1,0,1,0,18145,6.6,17219,199,46,-3228,-2075,19.9,1814.5,14,4,0,16,10,13,1,1,0,0,21373,7.2,19294,237,38,3228,2075,23.7,2137.3
4518553982,13,3,0,11,9,17,0,0,0,0,17774,6.6,17519,193,42,74,-513,19.3,1777.4,15,2,1,9,11,10,0,0,0,0,17700,6.8,18032,221,52,-74,513,22.1,1770.0
4522477887,21,2,1,11,11,13,0,0,0,0,18878,6.8,18276,222,48,1212,-257,22.2,1887.8,18,2,0,11,11,8,0,0,0,0,17666,7.0,18533,212,40,-1212,257,21.2,1766.6
4524784453,18,3,1,5,3,10,1,1,0,0,15717,7.0,17819,211,59,385,-71,21.1,1571.7,21,1,0,3,5,3,0,0,0,0,15332,7.0,17890,231,61,-385,71,23.1,1533.2
4497173280,18,2,1,11,9,5,0,0,0,0,18702,7.4,18736,234,53,1713,1791,23.4,1870.2,15,3,0,9,11,6,0,0,0,0,16989,6.6,16945,179,38,-1713,-1791,17.9,1698.9
4524332447,18,4,0,5,4,3,1,1,0,0,15296,6.8,16908,187,56,733,810,18.7,1529.6,24,4,1,4,5,1,0,0,0,0,14563,6.2,16098,204,32,-733,-810,20.4,1456.3
4512033848,16,4,1,7,5,7,1,0,1,0,17271,7.0,18144,246,51,2369,2245,24.6,1727.1,20,4,0,5,7,4,1,1,0,0,14902,6.4,15899,190,56,-2369,-2245,19.0,1490.2
4477447831,19,4,0,6,5,8,1,1,0,0,15416,6.8,17061,199,55,-1342,-713,19.9,1541.6,34,4,1,5,6,7,0,0,0,0,16758,6.8,17774,248,50,1342,713,24.8,1675.8
4442406122,14,2,1,13,6,14,0,0,0,0,19324,7.0,19019,226,55,3110,1541,22.6,1932.4,17,1,0,6,13,8,1,1,0,0,16214,7.0,17478,206,56,-3110,-1541,20.6,1621.4
4470994961,27,5,0,8,13,8,0,0,0,0,17238,7.0,17907,204,49,-2693,-709,20.4,1723.8,15,4,1,13,8,9,0,0,0,0,19931,7.2,18616,228,49,2693,709,22.8,1993.1
4517744758,15,2,1,8,3,7,1,0,1,0,17194,7.2,18529,197,48,2772,2140,19.7,1719.4,56,3,0,3,8,3,0,0,0,0,14422,6.6,16389,188,44,-2772,-2140,18.8,1442.2
4440235143,15,3,1,9,8,13,1,0,1,0,18146,6.6,17263,199,40,383,-1655,19.9,1814.6,19,2,0,8,9,10,0,0,0,0,17763,7.4,18918,201,60,-383,1655,20.1,1776.3
4524501776,19,1,1,11,6,15,1,1,0,0,18230,6.8,17602,195,52,2114,75,19.5,1823.0,14,2,0,6,11,7,0,0,0,0,16116,6.8,17527,198,52,-2114,-75,19.8,1611.6
4486653289,12,0,1,3,3,4,0,0,0,0,14520,7.0,17410,182,64,-1127,-843,18.2,1452.0,16,2,0,3,3,1,0,0,0,0,15647,7.0,18253,234,60,1127,843,23.4,1564.7
4518463691,20,4,1,7,0,11,1,1,0,0,16942,6.6,17249,214,48,3843,2831,21.4,1694.2,12,3,0,0,7,0,0,0,0,0,13099,6.2,14418,191,46,-3843,-2831,19.1,1309.9
4500865627,38,4,1,3,6,3,0,0,0,0,15541,7.0,18700,236,48,-376,-71,23.6,1554.1,14,0,0,6,3,5,1,1,0,0,15917,7.0,18771,226,48,376,71,22.6,1591.7
4525144811,17,0,0,8,8,5,1,0,1,0,18233,7.4,19767,256,56,363,-533,25.6,1823.3,78,2,1,8,8,13,1,1,0,0,17870,7.6,20300,239,52,-363,533,23.9,1787.0
4477117307,18,1,1,4,6,8,0,0,0,0,15251,7.0,18342,197,39,-2343,-2231,19.7,1525.1,11,5,0,6,4,5,2,1,1,0,17594,7.4,20573,238,80,2343,2231,23.8,1759.4
4437257190,27,5,1,10,6,8,1,0,1,0,18392,6.8,18818,222,52,2263,1634,22.2,1839.2,18,1,0,6,10,5,1,1,0,0,16129,6.4,17184,213,60,-2263,-1634,21.3,1612.9
4450209621,21,3,0,8,9,9,2,1,1,0,17421,6.8,17858,217,44,-1330,378,21.7,1742.1,19,9,1,9,8,10,0,0,0,1,18751,7.0,17480,217,37,1330,-378,21.7,1875.1
4511106120,16,2,0,1,8,2,0,0,0,0,14055,6.6,16334,208,55,-4331,-2588,20.8,1405.5,43,4,1,8,1,10,1,1,0,0,18386,7.2,18922,226,56,4331,2588,22.6,1838.6
4509319311,18,2,1,8,5,12,1,1,0,0,17846,7.0,18097,192,67,2425,824,19.2,1784.6,15,1,0,5,8,4,1,0,1,0,15421,6.8,17273,215,48,-2425,-824,21.5,1542.1
4449694269,20,7,0,7,8,6,1,1,0,0,16685,6.8,17591,193,40,-335,-681,19.3,1668.5,29,4,1,8,7,7,1,0,1,0,17020,6.8,18272,228,47,335,681,22.8,1702.0
4497717401,14,1,0,5,8,3,0,0,0,0,16367,7.2,18191,254,48,-1204,-717,25.4,1636.7,42,3,1,8,5,8,1,1,0,0,17571,7.0,18908,218,56,1204,717,21.8,1757.1
4518569254,38,4,1,5,7,6,1,1,0,0,15671,6.8,17411,205,44,-981,-994,20.5,1567.1,15,4,0,7,5,8,0,0,0,0,16652,6.8,18405,219,53,981,994,21.9,1665.2
4473157317,21,4,1,5,2,5,1,1,0,0,16724,7.0,18895,229,64,2432,1875,22.9,1672.4,17,0,0,2,5,3,0,0,0,0,14292,6.6,17020,221,44,-2432,-1875,22.1,1429.2
4525782560,18,6,1,7,5,5,1,0,1,1,18107,7.0,18102,236,46,2002,301,23.6,1810.7,34,2,0,5,7,6,0,0,0,0,16105,6.6,17801,217,68,-2002,-301,21.7,1610.5
4493323952,17,4,0,8,3,14,0,0,0,1,18823,6.6,18188,245,47,4509,2253,24.5,1882.3,14,4,1,3,8,2,1,1,0,0,14314,6.6,15935,218,40,-4509,-2253,21.8,1431.4
4500229448,48,3,0,5,7,3,1,1,0,0,16103,6.8,17939,216,52,-511,303,21.6,1610.3,17,3,1,7,5,9,0,0,0,0,16614,7.0,17636,237,36,511,-303,23.7,1661.4
4489404475,18,3,0,7,5,8,0,0,0,0,16525,6.8,17494,191,51,67,-303,19.1,1652.5,15,0,1,5,7,5,0,0,0,0,16458,7.0,17797,228,46,-67,303,22.8,1645.8
4498216793,38,6,0,6,10,6,2,1,1,0,15573,6.8,18078,194,43,-4673,-1225,19.4,1557.3,19,2,1,10,6,10,0,0,0,1,20246,7.2,19303,246,50,4673,1225,24.6,2024.6
4474160523,17,1,1,8,4,9,2,1,1,0,18293,7.4,19340,228,76,2406,2284,22.8,1829.3,14,3,0,4,8,7,0,0,0,0,15887,6.8,17056,224,52,-2406,-2284,22.4,1588.7
4514105796,12,3,0,2,9,1,0,0,0,0,14933,6.6,16470,225,56,-3251,-3208,22.5,1493.3,16,1,1,9,2,7,0,0,0,0,18184,7.4,19678,241,43,3251,3208,24.1,1818.4
4510212768,16,1,1,10,6,11,0,0,0,0,18081,7.0,18813,207,63,2273,1714,20.7,1808.1,14,0,0,6,10,10,0,0,0,0,15808,6.8,17099,220,41,-2273,-1714,22.0,1580.8
4508717967,18,2,0,15,6,15,0,0,0,0,19931,7.0,18115,213,40,4375,3249,21.3,1993.1,17,1,1,6,15,6,0,0,0,0,15556,6.2,14866,169,40,-4375,-3249,16.9,1555.6
4508878155,11,5,1,9,6,10,0,0,0,0,18422,7.0,18184,219,49,2991,1357,21.9,1842.2,16,2,0,6,9,6,0,0,0,0,15431,6.6,16827,200,54,-2991,-1357,20.0,1543.1
4521841751,16,0,0,6,14,9,1,1,0,0,15544,6.2,15313,176,43,-4625,-3447,17.6,1554.4,14,5,1,14,6,17,1,0,1,1,20169,7.2,18760,239,40,4625,3447,23.9,2016.9
4497858921,15,2,1,5,4,4,0,0,0,0,15634,6.8,16355,201,45,71,-359,20.1,1563.4,14,1,0,4,5,4,1,1,0,0,15563,6.8,16714,222,38,-71,359,22.2,1556.3
4470191400,14,3,0,7,4,10,1,1,0,0,17978,7.4,18771,216,66,2604,432,21.6,1797.8,14,5,1,4,7,0,0,0,0,0,15374,7.0,18339,220,51,-2604,-432,22.0,1537.4
4503659177,17,3,0,9,7,11,0,0,0,0,17814,7.0,18465,206,51,1692,1775,20.6,1781.4,16,0,1,7,9,11,0,0,0,0,16122,6.8,16690,196,42,-1692,-1775,19.6,1612.2
4512312350,16,2,1,7,4,4,1,1,0,0,17107,7.2,19237,218,68,2169,2453,21.8,1710.7,30,1,0,4,7,4,0,0,0,0,14938,6.6,16784,212,40,-2169,-2453,21.2,1493.8
4514102884,15,4,0,2,5,2,0,0,0,0,14780,7.0,17765,249,51,-1828,-1146,24.9,1478.0,16,5,1,5,2,6,1,1,0,0,16608,7.2,18911,230,84,1828,1146,23.0,1660.8
4446797537,14,2,0,5,6,6,1,1,0,0,17251,7.4,19984,233,76,334,955,23.3,1725.1,16,2,1,6,5,5,0,0,0,0,16917,7.0,19029,230,60,-334,-955,23.0,1691.7
4510888904,18,2,0,8,13,5,0,0,0,0,16077,6.8,16712,180,48,-3056,-2462,18.0,1607.7,17,4,1,13,8,12,0,0,0,0,19133,7.2,19174,223,38,3056,2462,22.3,1913.3
4501459269,12,5,1,8,9,15,0,0,0,0,18315,7.0,18534,209,51,246,1266,20.9,1831.5,17,0,0,9,8,8,1,1,0,0,18069,6.8,17268,208,46,-246,-1266,20.8,1806.9
4422002181,28,1,1,10,4,13,0,0,0,0,18858,7.0,18627,195,77,2674,1630,19.5,1885.8,13,2,0,4,10,4,0,0,0,0,16184,6.4,16997,240,52,-2674,-1630,24.0,1618.4
4511683858,16,6,0,5,7,4,0,0,0,0,15437,7.0,17811,195,68,-2205,-1308,19.5,1543.7,17,4,1,7,5,6,1,1,0,0,17642,7.2,19119,270,40,2205,1308,27.0,1764.2
4522605613,36,3,1,6,5,4,0,0,0,0,15956,7.0,17947,229,43,56,-587,22.9,1595.6,18,1,0,5,6,2,1,1,0,0,15900,7.0,18534,231,44,-56,587,23.1,1590.0
4527280212,44,4,1,12,3,14,0,0,0,0,18631,7.4,19460,245,42,4089,3372,24.5,1863.1,15,6,0,3,12,4,1,1,0,0,14542,6.4,16088,193,60,-4089,-3372,19.3,1454.2
4454438289,15,1,1,8,10,15,1,1,0,0,17231,7.0,17898,193,59,-1471,-1810,19.3,1723.1,16,5,0,10,8,11,0,0,0,0,18702,7.2,19708,213,52,1471,1810,21.3,1870.2
4524899991,17,2,1,12,6,11,1,1,0,0,19189,7.4,20302,227,49,3815,2726,22.7,1918.9,16,1,0,6,12,5,0,0,0,0,15374,6.6,17576,203,50,-3815,-2726,20.3,1537.4
4526372741,12,1,1,10,4,9,1,1,0,0,18009,7.4,19630,226,56,3026,1849,22.6,1800.9,35,4,0,4,10,1,0,0,0,0,14983,6.8,17781,205,51,-3026,-1849,20.5,1498.3
4483634862,14,1,0,5,12,5,0,0,0,0,15634,6.6,16435,222,40,-3194,-2675,22.2,1563.4,50,2,1,12,5,13,1,0,1,0,18828,7.2,19110,205,52,3194,2675,20.5,1882.8
4522377959,15,0,0,10,5,14,0,0,0,0,17993,6.6,16834,222,36,2876,2805,22.2,1799.3,14,3,1,5,10,8,0,0,0,0,15117,6.0,14029,180,36,-2876,-2805,18.0,1511.7
4512229508,20,1,0,7,9,6,0,0,0,0,17214,7.0,18251,231,49,-1806,123,23.1,1721.4,23,6,1,9,7,13,1,1,0,1,19020,7.0,18128,204,54,1806,-123,20.4,1902.0
4513704975,12,2,0,3,11,4,0,0,0,0,14738,6.4,17148,197,63,-4199,-3186,19.7,1473.8,16,3,1,11,3,7,1,1,0,0,18937,7.6,20334,241,56,4199,3186,24.1,1893.7
4518445145,15,1,1,5,1,5,2,1,1,0,17065,7.0,18930,220,54,2717,1557,22.0,1706.5,12,4,0,1,5,1,0,0,0,0,14348,7.0,17373,227,62,-2717,-1557,22.7,1434.8
4518730681,13,1,0,7,6,8,2,1,1,0,16514,6.8,17281,216,50,-594,-1344,21.6,1651.4,9,2,1,6,7,11,0,0,0,0,17108,7.0,18625,242,55,594,1344,24.2,1710.8
4459259003,19,4,1,10,1,7,0,0,0,0,18152,7.2,19147,233,47,4263,2953,23.3,1815.2,16,3,0,1,10,2,1,0,1,0,13889,6.6,16194,204,55,-4263,-2953,20.4,1388.9
4518182783,16,1,0,5,6,6,1,0,1,0,14853,6.4,16170,174,48,-2673,-1867,17.4,1485.3,56,5,1,6,5,8,1,1,0,0,17526,7.0,18037,246,56,2673,1867,24.6,1752.6
4515839148,20,3,1,7,8,5,0,0,0,0,16396,7.2,18362,209,36,-389,-29,20.9,1639.6,13,2,0,8,7,10,1,1,0,0,16785,7.0,18391,213,51,389,29,21.3,1678.5
4519619414,12,1,0,6,8,7,1,0,1,1,18155,7.0,19429,231,65,468,558,23.1,1815.5,12,3,1,8,6,11,1,1,0,0,17687,7.0,18871,194,56,-468,-558,19.4,1768.7
4500724554,17,4,0,3,13,3,0,0,0,0,14467,6.6,16331,209,44,-5563,-4698,20.9,1446.7,18,2,1,13,3,8,2,1,1,0,20030,7.6,21029,235,70,5563,4698,23.5,2003.0
4465204267,40,4,0,1,7,1,0,0,0,0,13556,6.8,16451,200,48,-3846,-2306,20.0,1355.6,17,5,1,7,1,7,1,1,0,0,17402,7.2,18757,253,52,3846,2306,25.3,1740.2
4511716965,15,3,0,9,4,12,1,0,1,0,18710,7.6,20305,210,80,3467,3958,21.0,1871.0,18,1,1,4,9,3,0,0,0,0,15243,6.4,16347,193,52,-3467,-3958,19.3,1524.3
4523523505,12,2,1,7,1,12,1,1,0,0,17149,7.0,19250,216,53,3370,2895,21.6,1714.9,15,0,0,1,7,0,0,0,0,0,13779,6.4,16355,209,52,-3370,-2895,20.9,1377.9
4448119077,56,3,1,9,4,16,1,1,0,0,17326,6.8,18168,188,58,1209,574,18.8,1732.6,18,3,0,4,9,5,0,0,0,0,16117,6.8,17594,231,33,-1209,-574,23.1,1611.7
4494451554,19,2,0,7,5,9,1,1,0,0,16847,7.0,17670,209,43,505,-1017,20.9,1684.7,14,4,1,5,7,5,0,0,0,0,16342,7.2,18687,212,68,-505,1017,21.2,1634.2
4522408229,26,3,1,5,2,4,2,1,1,0,16515,7.2,18870,257,54,1967,1068,25.7,1651.5,17,2,0,2,5,3,0,0,0,0,14548,7.0,17802,233,48,-1967,-1068,23.3,1454.8
4502093881,17,6,1,9,4,8,0,0,0,0,18439,7.0,19278,249,38,3020,2593,24.9,1843.9,12,2,0,4,9,8,0,0,0,0,15419,6.6,16685,211,46,-3020,-2593,21.1,1541.9
4521424727,17,3,1,7,6,6,0,0,0,0,16778,7.0,17473,205,59,1153,282,20.5,1677.8,18,2,0,6,7,9,1,1,0,0,15625,6.6,17191,203,52,-1153,-282,20.3,1562.5
4515729442,15,5,0,5,6,7,1,0,1,0,15913,6.8,17592,202,41,-844,-689,20.2,1591.3,16,3,1,6,5,3,1,1,0,0,16757,7.2,18281,247,56,844,689,24.7,1675.7
4476704273,16,0,1,5,6,4,1,1,0,0,16180,7.2,18710,234,60,-1348,-407,23.4,1618.0,16,1,0,6,5,6,0,0,0,0,17528,7.0,19117,245,55,1348,407,24.5,1752.8
4520688318,54,4,0,11,6,22,1,0,1,0,18640,7.0,18015,226,48,1931,1200,22.6,1864.0,13,2,1,6,11,10,1,1,0,0,16709,6.6,16815,232,62,-1931,-1200,23.2,1670.9
4521969261,11,0,1,5,6,4,1,1,0,0,15548,7.0,18653,181,68,-1238,-1708,18.1,1554.8,17,1,0,6,5,5,0,0,0,0,16786,7.4,20361,219,60,1238,1708,21.9,1678.6
4511383179,14,4,1,5,2,5,2,1,1,0,16627,6.8,18676,223,50,2359,1681,22.3,1662.7,14,3,0,2,5,3,0,0,0,0,14268,6.6,16995,221,45,-2359,-1681,22.1,1426.8
4524750008,15,4,1,6,5,7,1,1,0,0,15138,6.6,16193,191,43,-452,-1060,19.1,1513.8,16,5,0,5,6,5,0,0,0,0,15590,7.0,17253,206,56,452,1060,20.6,1559.0
4516589637,14,1,0,9,8,8,0,0,0,0,16676,7.2,18316,201,47,-978,-1076,20.1,1667.6,31,2,1,8,9,11,0,0,0,0,17654,7.4,19392,203,59,978,1076,20.3,1765.4
4524144661,21,0,1,4,3,7,1,1,0,0,15796,6.8,16848,221,54,724,-1747,22.1,1579.6,10,2,0,3,4,3,0,0,0,0,15072,7.2,18595,209,56,-724,1747,20.9,1507.2
4513003533,22,3,0,9,10,14,1,1,0,0,16749,6.4,16227,166,48,-2419,-3313,16.6,1674.9,19,1,1,10,9,13,0,0,0,0,19168,7.4,19540,240,39,2419,3313,24.0,1916.8
4525947675,16,2,1,3,7,4,1,1,0,0,15641,7.0,18490,261,56,-371,-444,26.1,1564.1,62,4,0,7,3,7,0,0,0,0,16012,7.0,18934,209,53,371,444,20.9,1601.2
4439683972,20,1,1,5,3,7,1,0,1,0,16610,7.4,19266,246,56,1875,2074,24.6,1661.0,14,1,0,3,5,3,1,1,0,0,14735,6.8,17192,207,52,-1875,-2074,20.7,1473.5
4521659923,13,1,1,8,3,8,1,1,0,0,18404,7.4,19768,245,60,3993,2165,24.5,1840.4,62,2,0,3,8,6,0,0,0,0,14411,7.2,17603,188,44,-3993,-2165,18.8,1441.1
4514563182,18,1,0,9,5,5,1,0,1,0,16835,6.8,17752,200,48,606,533,20.0,1683.5,13,3,1,5,9,6,0,0,0,0,16229,6.8,17219,211,55,-606,-533,21.1,1622.9
4518322850,17,2,1,6,7,5,0,0,0,0,16797,7.0,18636,213,65,823,2681,21.3,1679.7,14,2,0,7,6,11,1,0,1,0,15974,6.4,15955,158,44,-823,-2681,15.8,1597.4
4426718140,24,3,1,5,8,7,1,0,1,0,16137,6.6,17271,219,51,-80,-155,21.9,1613.7,16,6,0,8,5,9,1,1,0,0,16217,7.0,17426,205,40,80,155,20.5,1621.7
4463368363,18,1,1,8,5,7,2,1,1,0,18357,7.0,19718,269,56,3346,3707,26.9,1835.7,81,1,0,5,8,4,0,0,0,0,15011,6.6,16011,176,45,-3346,-3707,17.6,1501.1
4440210667,15,2,1,2,7,1,0,0,0,0,14624,6.8,17333,225,44,-2794,-2624,22.5,1462.4,39,5,0,7,2,13,0,0,0,0,17418,7.4,19957,231,60,2794,2624,23.1,1741.8
4519183876,15,1,1,11,3,11,2,1,1,0,18866,7.6,20876,214,60,3650,3906,21.4,1886.6,11,1,0,3,11,4,0,0,0,0,15216,6.8,16970,219,44,-3650,-3906,21.9,1521.6
4519130933,19,2,0,9,5,10,1,1,0,0,17967,7.0,18521,209,52,3066,2798,20.9,1796.7,15,4,1,5,9,4,0,0,0,0,14901,6.4,15723,177,31,-3066,-2798,17.7,1490.1
4503773782,39,2,1,4,4,5,1,1,0,0,15736,7.2,18719,231,56,131,1381,23.1,1573.6,15,0,0,4,4,4,0,0,0,0,15605,7.0,17338,246,43,-131,-1381,24.6,1560.5
4515674132,39,0,0,6,8,8,0,0,0,0,16065,7.0,17606,193,50,-1823,-2149,19.3,1606.5,13,1,1,8,6,7,1,1,0,0,17888,7.4,19755,234,63,1823,2149,23.4,1788.8
4455128161,18,2,1,13,2,16,1,1,0,0,19773,7.6,20507,240,40,5622,3964,24.0,1977.3,13,3,0,2,13,4,0,0,0,0,14151,6.6,16543,203,64,-5622,-3964,20.3,1415.1
4516853831,47,4,1,9,9,18,0,0,0,0,17284,6.2,15506,182,42,550,-371,18.2,1728.4,17,2,0,9,9,15,0,0,0,0,16734,6.6,15877,192,44,-550,371,19.2,1673.4
4494997427,50,2,1,4,4,4,0,0,0,0,15514,6.6,16759,223,40,249,182,22.3,1551.4,17,3,0,4,4,5,1,1,0,0,15265,6.6,16577,204,45,-249,-182,20.4,1526.5
4524643428,19,4,1,12,2,13,1,1,0,0,19320,7.4,20189,251,37,4544,3126,25.1,1932.0,17,4,0,2,12,2,0,0,0,0,14776,6.8,17063,206,52,-4544,-3126,20.6,1477.6
4495813537,16,4,1,8,4,9,1,0,1,0,18001,7.2,19477,233,55,2111,1390,23.3,1800.1,16,6,0,4,8,5,1,1,0,0,15890,6.8,18087,228,71,-2111,-1390,22.8,1589.0
4527487393,39,2,1,5,9,6,0,0,0,0,15863,7.0,17499,228,46,-1117,-764,22.8,1586.3,20,2,0,9,5,13,1,1,0,0,16980,7.0,18263,213,42,1117,764,21.3,1698.0
4524469439,16,2,1,8,10,7,1,1,0,0,16576,7.0,17437,226,34,-1147,-1294,22.6,1657.6,16,6,0,10,8,11,0,0,0,0,17723,7.2,18731,210,35,1147,1294,21.0,1772.3
4523053745,14,1,0,1,7,3,0,0,0,0,12959,6.4,15381,172,43,-4456,-2336,17.2,1295.9,52,3,1,7,1,17,0,0,0,0,17415,6.8,17717,196,51,4456,2336,19.6,1741.5
4527909697,40,4,0,4,1,13,2,1,1,0,16047,7.0,18644,244,48,1976,1778,24.4,1604.7,13,6,1,1,4,1,0,0,0,0,14071,6.8,16866,222,44,-1976,-1778,22.2,1407.1
4513996335,41,3,1,7,7,7,1,1,0,0,16491,6.6,16774,190,60,453,-1745,19.0,1649.1,16,6,0,7,7,0,0,0,0,0,16038,7.0,18519,238,51,-453,1745,23.8,1603.8
4524313607,15,2,1,5,6,8,0,0,0,0,15292,7.0,18345,187,54,-1805,-504,18.7,1529.2,18,3,0,6,5,10,1,1,0,0,17097,7.0,18849,241,64,1805,504,24.1,1709.7
4520789246,11,0,0,5,10,5,0,0,0,0,14740,6.4,15556,156,49,-4229,-4184,15.6,1474.0,16,3,1,10,5,12,1,1,0,0,18969,7.4,19740,220,64,4229,4184,22.0,1896.9
4489787025,16,4,1,3,2,2,0,0,0,0,15426,7.0,17927,202,64,566,-248,20.2,1542.6,132,5,0,2,3,0,0,0,0,0,14860,6.8,18175,249,52,-566,248,24.9,1486.0
4464934797,50,2,0,6,8,7,0,0,0,0,15270,6.4,17079,181,49,-2630,-2204,18.1,1527.0,18,4,1,8,6,6,1,1,0,0,17900,7.2,19283,238,50,2630,2204,23.8,1790.0
4519844480,41,0,0,4,17,4,0,0,0,0,14838,6.0,15075,180,44,-6265,-3518,18.0,1483.8,14,13,1,17,4,24,1,0,1,0,21103,7.0,18593,194,28,6265,3518,19.4,2110.3
4524341789,15,7,1,11,3,12,1,1,0,1,20206,7.4,19702,221,52,6275,4789,22.1,2020.6,15,0,0,3,11,2,0,0,0,0,13931,6.2,14913,187,40,-6275,-4789,18.7,1393.1
4494516149,37,3,0,4,7,4,1,0,1,0,16388,7.0,17168,220,50,-420,-1518,22.0,1638.8,14,4,1,7,4,10,0,0,0,0,16808,7.2,18686,239,37,420,1518,23.9,1680.8
4526548398,15,3,1,5,4,9,0,0,0,0,15633,6.8,17562,222,44,148,-543,22.2,1563.3,17,3,0,4,5,4,0,0,0,0,15485,7.0,18105,210,56,-148,543,21.0,1548.5
4471426578,42,4,0,8,6,9,0,0,0,0,17026,7.2,18824,212,51,843,1776,21.2,1702.6,19,4,1,6,8,2,1,1,0,0,16183,7.0,17048,220,36,-843,-1776,22.0,1618.3
4517959994,16,1,0,4,6,6,0,0,0,0,16040,7.0,17545,214,64,109,66,21.4,1604.0,16,3,1,6,4,6,1,1,0,0,15931,6.8,17479,221,40,-109,-66,22.1,1593.1
4472899697,13,2,1,5,6,2,0,0,0,0,15470,6.8,17451,211,44,-522,-577,21.1,1547.0,41,2,0,6,5,4,1,1,0,0,15992,7.0,18028,209,52,522,577,20.9,1599.2
4448491393,19,3,0,0,6,0,0,0,0,0,13395,6.8,16282,207,47,-3275,-3254,20.7,1339.5,20,3,1,6,0,5,0,0,0,0,16670,7.2,19536,257,40,3275,3254,25.7,1667.0
4449098612,13,2,1,10,6,12,1,1,0,0,18516,7.0,19255,240,58,2019,674,24.0,1851.6,105,1,0,6,10,8,0,0,0,0,16497,7.2,18581,214,49,-2019,-674,21.4,1649.7
4470512125,18,3,0,8,2,5,1,0,1,0,17235,7.4,19304,227,53,3613,3509,22.7,1723.5,105,3,1,2,8,1,0,0,0,0,13622,6.4,15795,182,50,-3613,-3509,18.2,1362.2
4476300428,15,8,0,8,3,8,1,1,0,0,17429,7.4,19044,239,48,2800,2474,23.9,1742.9,15,5,1,3,8,1,0,0,0,0,14629,6.6,16570,197,66,-2800,-2474,19.7,1462.9
4482626954,16,3,1,12,1,10,0,0,0,0,18849,7.4,19281,231,43,5077,3251,23.1,1884.9,16,4,0,1,12,0,0,0,0,0,13772,6.6,16030,224,41,-5077,-3251,22.4,1377.2
4468031280,17,5,0,5,3,8,1,1,0,0,15574,6.8,17788,230,45,840,196,23.0,1557.4,14,2,1,3,5,1,0,0,0,0,14734,7.0,17592,203,59,-840,-196,20.3,1473.4
4524619548,18,3,1,3,5,4,1,0,1,0,15410,6.8,17797,216,65,-234,-406,21.6,1541.0,29,5,0,5,3,2,1,1,0,0,15644,7.0,18203,236,40,234,406,23.6,1564.4
4510356766,16,3,0,1,3,2,0,0,0,0,13496,6.6,16421,186,50,-2452,-2422,18.6,1349.6,15,6,1,3,1,3,1,1,0,0,15948,7.2,18843,255,64,2452,2422,25.5,1594.8
4502464132,87,3,1,7,4,7,1,1,0,0,16723,6.8,17764,193,52,2568,3054,19.3,1672.3,18,1,0,4,7,6,0,0,0,0,14155,6.2,14710,183,28,-2568,-3054,18.3,1415.5
4527372782,14,4,0,5,3,5,0,0,0,0,15897,7.0,18190,226,44,485,858,22.6,1589.7,15,3,1,3,5,3,0,0,0,0,15412,6.8,17332,238,31,-485,-858,23.8,1541.2
4438638752,22,6,1,7,4,5,1,1,0,0,17382,7.4,19669,218,75,2164,3151,21.8,1738.2,30,7,0,4,7,7,0,0,0,0,15218,6.6,16518,205,48,-2164,-3151,20.5,1521.8
4500004334,18,1,0,4,6,3,1,1,0,0,15377,7.2,18315,215,51,-1262,614,21.5,1537.7,13,2,1,6,4,5,0,0,0,0,16639,7.0,17701,225,66,1262,-614,22.5,1663.9
4518457045,18,0,0,3,6,4,0,0,0,0,15224,7.0,18728,228,49,-1611,97,22.8,1522.4,40,5,1,6,3,11,0,0,0,0,16835,7.2,18631,247,44,1611,-97,24.7,1683.5
4499812377,21,4,1,5,5,5,1,1,0,0,15371,6.8,16868,224,43,-612,-1300,22.4,1537.1,16,4,0,5,5,7,0,0,0,0,15983,7.2,18168,194,56,612,1300,19.4,1598.3
4526376483,17,2,0,5,7,9,0,0,0,0,14690,6.4,15168,188,40,-5426,-3115,18.8,1469.0,14,0,1,7,5,9,1,1,0,2,20116,7.0,18283,245,43,5426,3115,24.5,2011.6
4468739944,17,2,0,8,5,16,1,1,0,0,16291,6.8,16847,179,42,478,1166,17.9,1629.1,20,4,1,5,8,8,0,0,0,0,15813,6.4,15681,205,40,-478,-1166,20.5,1581.3
4521018486,18,1,0,7,5,2,0,0,0,0,15533,7.0,17431,186,48,147,582,18.6,1553.3,50,2,1,5,7,9,2,1,1,0,15386,6.6,16849,180,44,-147,-582,18.0,1538.6
4510989189,19,3,1,10,0,7,0,0,0,0,17684,7.4,19113,224,35,3847,2027,22.4,1768.4,13,3,0,0,10,0,0,0,0,0,13837,6.8,17086,217,53,-3847,-2027,21.7,1383.7
4379931850,18,2,0,3,6,3,1,0,1,0,15032,6.6,16832,213,48,-1683,-1363,21.3,1503.2,36,3,1,6,3,6,1,1,0,0,16715,7.0,18195,236,44,1683,1363,23.6,1671.5
4522609707,17,4,1,5,3,6,1,1,0,0,16053,7.0,17817,227,52,1614,1179,22.7,1605.3,51,6,0,3,5,4,0,0,0,0,14439,6.6,16638,206,50,-1614,-1179,20.6,1443.9
4478736587,12,5,0,3,7,3,0,0,0,0,15992,6.8,17572,251,52,-1323,-1622,25.1,1599.2,18,1,1,7,3,10,2,1,1,0,17315,7.2,19194,218,60,1323,1622,21.8,1731.5
4524189570,17,4,1,5,2,6,2,1,1,0,16053,6.8,17406,218,51,1703,1696,21.8,1605.3,15,2,0,2,5,2,0,0,0,0,14350,6.4,15710,206,48,-1703,-1696,20.6,1435.0
4516924172,14,2,1,8,10,3,1,0,1,0,16674,6.8,18357,223,40,-1577,-716,22.3,1667.4,81,1,0,10,8,11,0,0,0,0,18251,7.0,19073,209,50,1577,716,20.9,1825.1
4521657785,21,4,1,10,6,8,1,1,0,0,17561,6.8,18172,203,56,287,568,20.3,1756.1,17,4,0,6,10,4,0,0,0,0,17274,6.6,17604,228,41,-287,-568,22.8,1727.4
4503795353,16,6,0,7,8,7,1,0,1,0,16936,7.0,18077,236,43,-96,827,23.6,1693.6,20,5,1,8,7,8,1,1,0,0,17032,6.8,17250,211,52,96,-827,21.1,1703.2
4524637878,15,2,0,7,7,7,0,0,0,0,17332,7.0,18724,226,60,-6,1004,22.6,1733.2,15,1,1,7,7,9,2,1,1,0,17338,6.8,17720,188,56,6,-1004,18.8,1733.8
4432016778,14,3,0,12,8,13,0,0,0,0,19306,7.4,19792,218,32,1087,340,21.8,1930.6,18,0,1,8,12,8,2,1,1,0,18219,7.4,19452,222,60,-1087,-340,22.2,1821.9
4518053347,20,1,1,12,9,16,1,1,0,0,18345,6.8,17559,222,32,941,-561,22.2,1834.5,15,3,0,9,12,8,1,0,1,0,17404,7.0,18120,207,48,-941,561,20.7,1740.4
4515418492,18,1,1,3,7,3,0,0,0,0,14951,6.8,17632,206,48,-2002,-565,20.6,1495.1,15,2,0,7,3,6,1,1,0,0,16953,7.0,18197,214,59,2002,565,21.4,1695.3
4511899232,22,6,0,6,7,6,0,0,0,0,17170,7.0,18110,243,60,959,2183,24.3,1717.0,17,6,1,7,6,10,0,0,0,0,16211,6.4,15927,194,36,-959,-2183,19.4,1621.1
4527439661,20,0,1,13,8,20,1,1,0,0,17564,6.6,15596,167,28,2032,1193,16.7,1756.4,18,2,0,8,13,10,0,0,0,0,15532,6.0,14403,170,34,-2032,-1193,17.0,1553.2
4466552109,26,1,1,3,5,3,1,1,0,0,15043,6.8,17227,225,47,-1591,-1829,22.5,1504.3,15,2,0,5,3,4,1,0,1,0,16634,7.4,19056,236,52,1591,1829,23.6,1663.4
4488518196,17,2,1,6,5,8,1,1,0,0,16168,6.8,17052,176,60,-1149,-1327,17.6,1616.8,17,2,0,5,6,9,1,0,1,0,17317,7.0,18379,263,60,1149,1327,26.3,1731.7
4523956111,14,0,1,4,0,6,1,1,0,0,16070,7.2,19798,236,72,2170,2480,23.6,1607.0,13,0,0,0,4,0,0,0,0,0,13900,6.8,17318,240,48,-2170,-2480,24.0,1390.0
4500662035,14,4,1,7,2,6,0,0,0,0,16315,7.0,18067,201,60,1167,510,20.1,1631.5,17,2,0,2,7,2,0,0,0,0,15148,6.8,17557,240,59,-1167,-510,24.0,1514.8
4489785292,19,4,0,6,11,8,0,0,0,0,15887,6.4,16048,191,48,-2596,-2891,19.1,1588.7,15,5,1,11,6,13,0,0,0,0,18483,7.2,18939,220,51,2596,2891,22.0,1848.3
4516990759,57,5,1,6,4,3,0,0,0,0,16601,7.0,18618,242,52,1235,1010,24.2,1660.1,15,3,0,4,6,5,0,0,0,0,15366,6.8,17608,201,44,-1235,-1010,20.1,1536.6
4462918469,22,6,0,1,5,1,0,0,0,0,15065,6.8,17423,252,68,-950,-1785,25.2,1506.5,29,3,1,5,1,6,0,0,0,0,16015,7.2,19208,238,55,950,1785,23.8,1601.5
4470363141,16,4,1,6,7,6,0,0,0,0,17035,7.2,18588,235,60,501,-495,23.5,1703.5,14,3,0,7,6,4,0,0,0,0,16534,7.0,19083,207,60,-501,495,20.7,1653.4
4502985762,15,1,1,4,1,4,0,0,0,0,16008,7.2,19253,247,45,344,1298,24.7,1600.8,15,3,0,1,4,2,0,0,0,0,15664,7.0,17955,264,52,-344,-1298,26.4,1566.4
4518215400,18,1,0,7,8,5,0,0,0,0,16768,7.2,19368,225,58,-268,-155,22.5,1676.8,15,2,1,8,7,9,1,1,0,0,17036,7.2,19523,221,65,268,155,22.1,1703.6
4510548126,16,3,1,4,11,4,0,0,0,0,16314,6.8,16894,250,48,-2665,-900,25.0,1631.4,17,5,0,11,4,14,2,1,1,1,18979,7.0,17794,200,58,2665,900,20.0,1897.9
4463251548,14,7,1,9,9,13,2,1,1,0,17125,6.8,16776,191,52,-206,-363,19.1,1712.5,17,1,0,9,9,7,0,0,0,0,17331,6.6,17139,204,48,206,363,20.4,1733.1
4465556505,44,4,0,8,4,9,1,1,0,0,16923,6.8,18443,195,60,2504,2824,19.5,1692.3,17,2,1,4,8,3,0,0,0,0,14419,6.4,15619,199,29,-2504,-2824,19.9,1441.9
4524113252,20,1,1,7,11,7,0,0,0,0,16171,6.4,16252,166,52,-2171,-2897,16.6,1617.1,21,5,0,11,7,13,1,1,0,0,18342,7.0,19149,220,43,2171,2897,22.0,1834.2
4444095470,15,5,0,3,8,2,0,0,0,0,15453,7.2,18464,209,63,-664,615,20.9,1545.3,18,3,1,8,3,8,1,1,0,0,16117,7.0,17849,180,48,664,-615,18.0,1611.7
4499522050,20,2,0,3,3,1,1,0,1,1,17009,7.2,18492,238,78,862,1098,23.8,1700.9,19,9,1,3,3,5,1,1,0,0,16147,6.8,17394,252,69,-862,-1098,25.2,1614.7
4489800281,9,2,0,6,8,7,0,0,0,0,16730,7.0,17780,208,49,-828,-1255,20.8,1673.0,14,1,1,8,6,7,0,0,0,0,17558,7.2,19035,233,60,828,1255,23.3,1755.8
4459463690,15,6,0,4,4,5,1,1,0,0,15676,7.0,19069,231,61,-261,443,23.1,1567.6,59,1,1,4,4,8,1,0,1,0,15937,6.8,18626,231,56,261,-443,23.1,1593.7
4526866944,17,3,1,7,4,12,1,1,0,0,17199,7.0,19299,229,59,1545,1417,22.9,1719.9,16,2,0,4,7,5,0,0,0,0,15654,7.2,17882,226,53,-1545,-1417,22.6,1565.4
4527729232,36,3,0,4,13,5,0,0,0,0,14478,6.2,14665,171,32,-5087,-4618,17.1,1447.8,40,3,1,13,4,12,0,0,0,0,19565,7.2,19283,199,71,5087,4618,19.9,1956.5
4417615828,14,1,0,6,6,7,1,1,0,0,16642,7.0,18251,218,52,-348,-611,21.8,1664.2,15,0,1,6,6,4,1,0,1,0,16990,7.0,18862,237,40,348,611,23.7,1699.0
4424223586,15,5,0,6,6,6,0,0,0,0,16763,6.8,17822,207,52,54,-119,20.7,1676.3,20,3,1,6,6,7,1,1,0,0,16709,6.8,17941,214,53,-54,119,21.4,1670.9
4526211011,14,2,0,5,7,4,0,0,0,0,15553,6.6,15768,203,40,-977,-2180,20.3,1555.3,17,0,1,7,5,5,2,1,1,0,16530,7.0,17948,222,54,977,2180,22.2,1653.0
4514431388,15,4,1,6,5,7,1,1,0,0,15906,7.0,17700,232,39,-39,464,23.2,1590.6,13,5,0,5,6,9,0,0,0,0,15945,6.6,17236,197,45,39,-464,19.7,1594.5
4454069388,41,4,1,7,8,8,0,0,0,0,16604,6.6,17328,203,47,-416,-907,20.3,1660.4,17,6,0,8,7,11,1,1,0,0,17020,7.0,18235,201,55,416,907,20.1,1702.0
4466982463,17,0,1,4,5,2,1,1,0,0,15557,6.8,17180,234,53,-633,-1323,23.4,1555.7,14,1,0,5,4,6,0,0,0,0,16190,7.0,18503,206,54,633,1323,20.6,1619.0
4498448542,21,2,0,3,3,3,2,1,1,0,15956,6.8,18145,215,73,656,526,21.5,1595.6,15,5,1,3,3,5,0,0,0,0,15300,6.8,17619,212,50,-656,-526,21.2,1530.0
4520629363,16,2,0,4,4,3,2,1,1,0,15875,6.8,18309,234,65,455,1305,23.4,1587.5,15,4,1,4,4,6,0,0,0,0,15420,6.4,17004,233,42,-455,-1305,23.3,1542.0
4481879494,15,0,0,3,4,3,1,1,0,1,17437,7.2,18302,255,59,3156,3919,25.5,1743.7,11,1,1,4,3,6,0,0,0,0,14281,6.0,14383,196,31,-3156,-3919,19.6,1428.1
4518125145,17,2,1,8,8,13,0,0,0,0,16934,6.4,16045,193,44,247,-775,19.3,1693.4,15,1,0,8,8,6,1,1,0,0,16687,6.6,16820,191,56,-247,775,19.1,1668.7
4446053181,15,2,0,5,6,8,0,0,0,0,15964,6.8,17988,206,65,-243,860,20.6,1596.4,17,2,1,6,5,8,2,1,1,0,16207,6.6,17128,205,43,243,-860,20.5,1620.7
4527222225,42,3,0,7,4,5,2,1,1,0,16468,6.8,17897,224,44,142,-58,22.4,1646.8,18,8,1,4,7,6,0,0,0,0,16326,7.0,17955,209,64,-142,58,20.9,1632.6
4453463831,14,3,1,4,6,4,1,1,0,0,16209,7.2,18802,235,72,-907,-1159,23.5,1620.9,17,5,0,6,4,7,0,0,0,0,17116,7.2,19961,242,62,907,1159,24.2,1711.6
4493140120,17,7,1,4,2,2,0,0,0,0,16452,7.2,19307,273,60,1068,618,27.3,1645.2,16,4,0,2,4,4,0,0,0,0,15384,7.2,18689,253,68,-1068,-618,25.3,1538.4
4520585674,18,5,0,6,4,7,0,0,0,0,16421,7.0,18708,224,44,267,-52,22.4,1642.1,16,9,1,4,6,7,1,1,0,0,16154,7.2,18760,241,55,-267,52,24.1,1615.4
4523278950,17,1,0,3,5,5,0,0,0,0,14313,6.2,15407,194,52,-2089,-2275,19.4,1431.3,18,6,1,5,3,7,1,1,0,0,16402,6.8,17682,243,48,2089,2275,24.3,1640.2
4519625285,20,1,1,8,4,11,2,1,1,0,17385,6.8,18040,221,56,2745,1478,22.1,1738.5,16,3,0,4,8,6,0,0,0,0,14640,6.6,16562,203,37,-2745,-1478,20.3,1464.0
4517987406,122,1,0,3,2,4,1,1,0,0,15033,6.8,18279,211,59,6,205,21.1,1503.3,107,2,1,2,3,2,0,0,0,0,15027,7.2,18074,221,57,-6,-205,22.1,1502.7
4522394402,19,2,1,9,9,12,1,1,0,0,17187,7.0,17605,197,38,-1675,-1382,19.7,1718.7,16,1,0,9,9,11,1,0,1,0,18862,7.2,18987,206,40,1675,1382,20.6,1886.2
4520654397,16,7,1,1,0,1,1,0,1,0,15268,7.2,18685,269,56,296,440,26.9,1526.8,21,2,0,0,1,0,1,1,0,0,14972,7.2,18245,251,71,-296,-440,25.1,1497.2
4518912050,15,3,0,8,9,8,2,1,1,0,18339,7.2,19765,233,62,-59,1231,23.3,1833.9,17,1,1,9,8,9,0,0,0,0,18398,7.0,18534,212,60,59,-1231,21.2,1839.8
4438396733,17,3,1,12,5,14,1,1,0,0,18499,7.0,17823,210,36,3473,2812,21.0,1849.9,15,1,0,5,12,6,0,0,0,0,15026,6.2,15011,204,20,-3473,-2812,20.4,1502.6
4517978315,17,2,0,4,9,4,0,0,0,0,14820,6.6,15946,184,44,-4156,-2933,18.4,1482.0,15,5,1,9,4,15,1,0,1,0,18976,7.0,18879,240,48,4156,2933,24.0,1897.6
4520898233,78,4,0,4,3,4,2,1,1,0,15906,6.8,19219,238,67,406,1283,23.8,1590.6,15,3,1,3,4,3,0,0,0,0,15500,7.0,17936,220,64,-406,-1283,22.0,1550.0
4491423800,16,0,0,6,8,5,1,1,0,0,15683,7.0,17335,186,54,-1906,-1476,18.6,1568.3,12,3,1,8,6,9,1,0,1,0,17589,7.0,18811,240,45,1906,1476,24.0,1758.9
4412284612,14,3,0,11,14,10,0,0,0,0,18420,7.2,19093,225,46,-1004,-515,22.5,1842.0,14,2,1,14,11,14,0,0,0,0,19424,7.2,19608,205,52,1004,515,20.5,1942.4
4496085988,18,2,1,4,2,5,0,0,0,0,16270,7.0,18684,248,60,454,333,24.8,1627.0,14,5,0,2,4,2,1,1,0,0,15816,7.0,18351,257,48,-454,-333,25.7,1581.6
4518396542,30,4,1,8,4,4,1,1,0,0,17038,7.2,18971,233,60,1530,334,23.3,1703.8,37,2,0,4,8,2,1,0,1,0,15508,6.8,18637,233,48,-1530,-334,23.3,1550.8
4505403710,15,3,1,7,2,13,1,1,0,0,16739,7.0,17995,229,56,1569,664,22.9,1673.9,16,0,0,2,7,2,0,0,0,0,15170,6.8,17331,250,48,-1569,-664,25.0,1517.0
4502024151,12,1,0,2,11,3,0,0,0,0,13832,6.6,16157,203,47,-6240,-4315,20.3,1383.2,13,3,1,11,2,11,2,1,1,1,20072,7.6,20472,233,49,6240,4315,23.3,2007.2
4523410225,17,0,1,6,5,10,0,0,0,0,16233,7.0,17076,223,38,70,-928,22.3,1623.3,19,2,0,5,6,7,2,1,1,0,16163,7.0,18004,225,76,-70,928,22.5,1616.3
4442047258,16,4,1,4,5,1,1,1,0,0,15855,7.0,18078,238,56,145,972,23.8,1585.5,17,3,0,5,4,7,0,0,0,0,15710,6.6,17106,224,36,-145,-972,22.4,1571.0
4523395238,23,5,1,9,2,8,1,1,0,0,17194,7.4,19161,221,40,2410,1034,22.1,1719.4,12,2,0,2,9,0,0,0,0,0,14784,6.8,18127,235,55,-2410,-1034,23.5,1478.4
4515543803,18,3,0,7,6,6,0,0,0,0,15847,6.6,16305,199,36,-1252,-1190,19.9,1584.7,16,5,1,6,7,6,1,0,1,0,17099,6.6,17495,231,51,1252,1190,23.1,1709.9
4483417316,36,3,1,7,4,4,1,1,0,0,16849,7.6,20518,234,68,1116,2834,23.4,1684.9,13,1,0,4,7,6,0,0,0,0,15733,6.8,17684,237,48,-1116,-2834,23.7,1573.3
4446116098,17,1,1,7,5,5,2,1,1,0,17227,7.6,20568,218,56,1329,1625,21.8,1722.7,13,4,0,5,7,3,0,0,0,0,15898,7.0,18943,207,73,-1329,-1625,20.7,1589.8
4524920237,24,3,1,5,11,6,0,0,0,0,16544,7.0,17851,222,53,-2929,-1731,22.2,1654.4,14,2,0,11,5,17,1,1,0,0,19473,7.2,19582,227,48,2929,1731,22.7,1947.3
4467751536,14,3,0,4,6,2,0,0,0,0,14360,6.6,16876,175,39,-3424,-1550,17.5,1436.0,17,5,1,6,4,4,1,1,0,1,17784,7.2,18426,207,48,3424,1550,20.7,1778.4
4460033852,12,2,1,5,5,5,0,0,0,0,15646,6.6,16889,186,50,-201,-1702,18.6,1564.6,19,0,0,5,5,2,2,1,1,0,15847,7.2,18591,247,58,201,1702,24.7,1584.7
4450814847,16,3,1,9,3,8,0,0,0,0,17997,7.6,20432,210,56,3087,2543,21.0,1799.7,40,2,0,3,9,4,1,1,0,0,14910,7.2,17889,225,60,-3087,-2543,22.5,1491.0
4516777697,14,0,1,9,7,7,0,0,0,0,17607,7.2,19309,212,50,716,601,21.2,1760.7,14,1,0,7,9,6,1,1,0,0,16891,7.2,18708,204,73,-716,-601,20.4,1689.1
4510100587,14,1,0,2,6,3,0,0,0,0,14950,7.0,18134,234,42,-1889,-723,23.4,1495.0,14,1,1,6,2,6,1,1,0,0,16839,7.0,18857,229,49,1889,723,22.9,1683.9
4522528585,14,3,0,8,8,5,1,1,0,0,17421,7.4,19535,244,49,-108,1254,24.4,1742.1,14,2,1,8,8,9,0,0,0,0,17529,7.0,18281,212,58,108,-1254,21.2,1752.9
4520801995,17,2,0,2,10,1,0,0,0,0,15239,7.0,18073,232,52,-3449,-1995,23.2,1523.9,17,0,1,10,2,13,1,1,0,0,18688,7.6,20068,231,57,3449,1995,23.1,1868.8
4477684980,18,5,1,6,8,6,0,0,0,0,17210,7.0,18131,220,72,1091,605,22.0,1721.0,51,3,0,8,6,10,0,0,0,0,16119,7.0,17526,178,32,-1091,-605,17.8,1611.9
4524282736,14,3,1,6,5,5,1,0,1,0,16594,7.0,18973,224,50,466,933,22.4,1659.4,40,4,0,5,6,8,1,1,0,0,16128,7.0,18040,233,52,-466,-933,23.3,1612.8
4523940286,18,2,0,5,6,8,2,1,1,0,16315,6.8,17744,236,56,199,403,23.6,1631.5,17,2,1,6,5,9,0,0,0,0,16116,6.6,17341,227,34,-199,-403,22.7,1611.6
4506444095,17,3,1,9,2,7,1,0,1,0,17017,7.0,19023,204,50,2350,2705,20.4,1701.7,13,3,0,2,9,3,1,1,0,0,14667,6.6,16318,220,72,-2350,-2705,22.0,1466.7
4503214718,20,2,1,1,2,1,0,0,0,0,13993,6.6,16977,213,43,-961,-1080,21.3,1399.3,38,2,0,2,1,2,1,0,1,0,14954,7.0,18057,235,63,961,1080,23.5,1495.4
4523592716,14,2,0,1,9,2,1,1,0,0,14041,6.6,16529,229,49,-4377,-4323,22.9,1404.1,16,3,1,9,1,5,0,0,0,0,18418,7.4,20852,234,79,4377,4323,23.4,1841.8
4521822365,16,2,1,3,6,4,1,1,0,0,14792,6.6,16218,205,52,-1183,-1235,20.5,1479.2,19,2,0,6,3,5,0,0,0,0,15975,6.8,17453,211,42,1183,1235,21.1,1597.5
4508386136,23,3,0,3,4,4,0,0,0,0,15031,6.8,16824,202,55,-330,-142,20.2,1503.1,17,1,1,4,3,5,1,0,1,0,15361,6.6,16966,215,46,330,142,21.5,1536.1
4520333259,16,5,0,6,4,7,0,0,0,0,16619,7.2,18958,226,51,1552,1488,22.6,1661.9,31,4,1,4,6,5,0,0,0,0,15067,6.8,17470,213,52,-1552,-1488,21.3,1506.7
4477725637,15,6,0,6,7,12,0,0,0,0,15656,6.4,16252,195,44,-1275,-551,19.5,1565.6,21,3,1,7,6,8,1,1,0,0,16931,6.6,16803,202,44,1275,551,20.2,1693.1
4518473968,13,3,1,7,6,6,0,0,0,0,17106,6.8,17550,226,47,1138,558,22.6,1710.6,16,1,0,6,7,5,1,0,1,0,15968,6.8,16992,202,39,-1138,-558,20.2,1596.8
4513650091,19,3,1,8,3,4,1,0,1,1,19224,7.6,20086,225,56,4674,2219,22.5,1922.4,34,3,0,3,8,4,1,1,0,0,14550,7.0,17867,189,64,-4674,-2219,18.9,1455.0
4515824128,19,3,1,7,6,8,0,0,0,0,16124,6.8,17018,192,52,-467,-86,19.2,1612.4,17,5,0,6,7,8,2,1,1,0,16591,6.8,17104,211,49,467,86,21.1,1659.1
4514309689,12,1,0,5,9,5,0,0,0,0,15400,7.0,17541,215,40,-4112,-2493,21.5,1540.0,16,1,1,9,5,9,0,0,0,0,19512,7.4,20034,219,72,4112,2493,21.9,1951.2
4451947704,83,2,1,5,5,7,0,0,0,0,16560,7.0,18547,225,50,761,830,22.5,1656.0,38,3,0,5,5,8,1,1,0,0,15799,6.8,17717,225,47,-761,-830,22.5,1579.9
4522569310,15,7,0,1,4,1,0,0,0,0,13512,6.4,16628,224,47,-2327,-742,22.4,1351.2,17,2,1,4,1,6,1,1,0,0,15839,7.0,17370,215,48,2327,742,21.5,1583.9
4474081068,88,2,0,4,3,4,0,0,0,0,17585,7.2,19376,270,55,3052,3581,27.0,1758.5,41,3,1,3,4,8,0,0,0,0,14533,6.6,15795,200,44,-3052,-3581,20.0,1453.3
4475645681,16,4,1,6,7,10,1,1,0,0,16447,7.0,18423,201,60,-168,376,20.1,1644.7,17,3,0,7,6,10,0,0,0,0,16615,7.0,18047,224,42,168,-376,22.4,1661.5
4490390200,13,3,0,7,5,2,1,1,0,0,17247,7.2,19189,249,63,2152,2575,24.9,1724.7,17,2,1,5,7,7,0,0,0,0,15095,6.8,16614,178,40,-2152,-2575,17.8,1509.5
4465778231,25,3,0,11,8,11,0,0,0,0,17666,6.8,16963,193,48,-184,-835,19.3,1766.6,13,2,1,8,11,12,0,0,0,0,17850,7.0,17798,234,52,184,835,23.4,1785.0
4523639973,21,2,0,3,5,3,2,1,1,0,16009,7.2,18511,268,55,-473,383,26.8,1600.9,16,6,1,5,3,7,0,0,0,0,16482,6.8,18128,246,46,473,-383,24.6,1648.2
4515568453,15,1,0,8,10,6,0,0,0,0,15995,6.8,17109,172,57,-3535,-1199,17.2,1599.5,11,0,1,10,8,13,1,1,0,1,19530,7.2,18308,220,44,3535,1199,22.0,1953.0
4522283833,13,1,0,4,5,7,0,0,0,0,15921,7.0,18190,217,48,-594,-353,21.7,1592.1,14,1,1,5,4,7,2,1,1,0,16515,7.2,18543,235,48,594,353,23.5,1651.5
4523699051,34,3,1,10,7,12,0,0,0,0,17951,6.6,17346,211,45,2095,628,21.1,1795.1,15,2,0,7,10,4,0,0,0,0,15856,6.8,16718,171,47,-2095,-628,17.1,1585.6
4469179994,56,3,1,8,6,17,0,0,0,0,16731,6.4,16329,205,56,266,-912,20.5,1673.1,17,4,0,6,8,6,1,1,0,0,16465,6.6,17241,218,35,-266,912,21.8,1646.5
4522194078,14,3,1,2,5,2,0,0,0,0,14695,6.8,17431,228,56,-2062,-1466,22.8,1469.5,13,3,0,5,2,6,1,1,0,0,16757,7.0,18897,246,58,2062,1466,24.6,1675.7
4494451002,16,4,1,8,3,7,1,1,0,0,16225,6.8,17748,179,44,195,428,17.9,1622.5,17,0,0,3,8,4,0,0,0,0,16030,6.6,17320,239,39,-195,-428,23.9,1603.0
4513514552,15,1,0,5,15,7,0,0,0,0,16203,6.6,17059,187,56,-5057,-3732,18.7,1620.3,19,3,1,15,5,16,1,1,0,0,21260,7.4,20791,255,56,5057,3732,25.5,2126.0
4502375792,13,1,0,6,14,5,1,0,1,1,16749,6.2,15390,203,23,-3586,-2840,20.3,1674.9,67,2,1,14,6,25,1,1,0,1,20335,7.2,18230,194,39,3586,2840,19.4,2033.5
4523672153,19,3,1,10,7,10,1,1,0,0,18312,6.8,18057,239,46,1250,-226,23.9,1831.2,17,4,0,7,10,5,1,0,1,0,17062,6.8,18283,206,57,-1250,226,20.6,1706.2
4509066141,16,4,0,5,3,10,0,0,0,1,16981,6.8,17309,214,38,384,-465,21.4,1698.1,21,1,1,3,5,2,2,1,1,1,16597,7.0,17774,224,64,-384,465,22.4,1659.7
4500092661,17,4,0,4,8,5,1,1,0,0,15591,7.0,17848,228,59,-1951,-1575,22.8,1559.1,19,4,1,8,4,6,0,0,0,0,17542,7.4,19423,236,42,1951,1575,23.6,1754.2
4518772710,14,4,1,8,5,2,2,1,1,0,18320,7.0,19311,268,55,3413,2303,26.8,1832.0,15,2,0,5,8,7,0,0,0,0,14907,6.6,17008,151,44,-3413,-2303,15.1,1490.7
4491980235,14,2,1,10,7,10,0,0,0,0,18296,7.0,18788,208,52,1011,17,20.8,1829.6,20,1,0,7,10,8,0,0,0,0,17285,7.0,18771,237,48,-1011,-17,23.7,1728.5
4522487692,14,3,0,3,6,4,0,0,0,0,15930,7.0,19263,241,71,-1240,-793,24.1,1593.0,14,4,1,6,3,6,1,1,0,0,17170,7.2,20056,252,64,1240,793,25.2,1717.0
4509940974,19,5,1,6,10,7,0,0,0,0,15787,6.8,16711,205,37,-2457,-1625,20.5,1578.7,22,6,0,10,6,10,1,0,1,0,18244,7.0,18336,238,53,2457,1625,23.8,1824.4
4524248852,39,1,1,9,8,5,0,0,0,0,16307,7.0,17660,194,32,-796,-217,19.4,1630.7,18,6,0,8,9,10,0,0,0,0,17103,6.8,17877,215,44,796,217,21.5,1710.3
4516104541,43,4,1,7,7,9,1,0,1,0,16342,6.8,17877,211,40,-2579,-1094,21.1,1634.2,35,3,0,7,7,6,1,1,0,1,18921,7.2,18971,238,81,2579,1094,23.8,1892.1
4521748513,15,5,1,5,6,5,0,0,0,0,15948,6.8,17169,222,54,-947,-1040,22.2,1594.8,23,3,0,6,5,10,2,1,1,0,16895,6.8,18209,248,51,947,1040,24.8,1689.5
4524740998,43,6,1,4,7,4,1,1,0,0,15176,6.4,16820,226,33,-1539,-1497,22.6,1517.6,23,9,0,7,4,12,0,0,0,0,16715,7.2,18317,205,52,1539,1497,20.5,1671.5
4521281559,16,5,0,9,7,6,1,0,1,0,17807,6.8,17661,217,42,1383,1273,21.7,1780.7,17,3,1,7,9,6,1,1,0,0,16424,6.6,16388,192,60,-1383,-1273,19.2,1642.4
4489674580,14,0,1,12,7,13,0,0,0,0,18291,7.2,18548,176,53,2182,1012,17.6,1829.1,13,2,0,7,12,4,0,0,0,0,16109,6.8,17536,210,48,-2182,-1012,21.0,1610.9
4455390955,39,1,0,1,5,1,0,0,0,0,13361,6.8,16819,174,48,-3006,-1880,17.4,1336.1,15,0,1,5,1,4,2,1,1,0,16367,7.0,18699,219,48,3006,1880,21.9,1636.7
4513002559,19,0,0,5,14,9,1,1,0,0,15423,6.8,16791,175,53,-6324,-3885,17.5,1542.3,14,1,1,14,5,14,1,0,1,1,21747,7.6,20676,233,44,6324,3885,23.3,2174.7
4522164250,15,6,0,2,7,2,0,0,0,0,14329,6.6,16330,211,47,-1966,-3591,21.1,1432.9,18,1,1,7,2,1,1,1,0,0,16295,7.2,19921,217,64,1966,3591,21.7,1629.5
4501847669,14,2,0,6,10,5,0,0,0,0,15256,6.6,16464,189,28,-1555,-357,18.9,1525.6,17,2,1,10,6,12,1,1,0,0,16811,6.8,16821,182,45,1555,357,18.2,1681.1
4437082520,16,4,1,10,6,11,1,1,0,0,17538,7.0,19111,219,48,34,145,21.9,1753.8,16,2,0,6,10,6,0,0,0,0,17504,7.2,18966,225,68,-34,-145,22.5,1750.4
4516510079,33,2,0,2,11,2,1,1,0,0,14099,6.6,16884,201,59,-3938,-2767,20.1,1409.9,18,1,1,11,2,8,0,0,0,0,18037,7.2,19651,218,53,3938,2767,21.8,1803.7
4475950279,12,1,0,5,13,5,0,0,0,0,15881,6.6,16662,215,52,-3438,-2574,21.5,1588.1,19,3,1,13,5,9,1,1,0,0,19319,7.2,19236,222,52,3438,2574,22.2,1931.9
4519757776,14,2,0,4,3,3,1,1,0,0,15988,7.0,18515,251,52,623,640,25.1,1598.8,14,2,1,3,4,2,1,0,1,0,15365,7.0,17875,234,56,-623,-640,23.4,1536.5
4523806896,19,0,0,3,8,4,0,0,0,0,14462,6.4,16255,210,43,-2247,-1501,21.0,1446.2,91,2,1,8,3,7,1,1,0,0,16709,6.8,17756,213,64,2247,1501,21.3,1670.9
4508799837,16,1,0,6,4,6,1,0,1,1,18625,7.4,19348,240,50,3163,1231,24.0,1862.5,16,2,1,4,6,6,1,1,0,0,15462,7.0,18117,230,46,-3163,-1231,23.0,1546.2
4511223295,13,0,0,4,13,3,0,0,0,0,15161,6.6,16945,196,60,-7089,-2815,19.6,1516.1,16,0,1,13,4,13,0,0,0,1,22250,7.2,19760,237,55,7089,2815,23.7,2225.0
4522608036,22,4,0,7,2,5,0,0,0,0,16696,7.2,18900,225,68,1945,2614,22.5,1669.6,17,4,1,2,7,3,0,0,0,0,14751,6.4,16286,196,52,-1945,-2614,19.6,1475.1
4468685425,40,1,0,3,8,3,0,0,0,0,14416,6.8,16951,185,38,-3253,-3049,18.5,1441.6,15,15,1,8,3,9,1,1,0,0,17669,7.6,20000,229,60,3253,3049,22.9,1766.9
4481425277,18,1,0,6,6,12,1,1,0,0,16951,7.0,18426,229,49,248,-219,22.9,1695.1,15,1,1,6,6,7,1,0,1,0,16703,6.8,18645,245,60,-248,219,24.5,1670.3
4508000311,15,2,0,2,3,2,1,0,1,0,13978,6.6,16429,180,44,-977,-1025,18.0,1397.8,12,4,1,3,2,1,0,0,0,0,14955,6.8,17454,218,56,977,1025,21.8,1495.5
4507824198,17,1,1,7,2,5,1,0,1,0,16649,7.4,19322,226,47,1256,-295,22.6,1664.9,16,6,0,2,7,1,1,1,0,0,15393,7.4,19617,268,63,-1256,295,26.8,1539.3
4502105412,23,1,0,9,4,9,2,1,1,0,18264,7.4,20134,234,75,2188,2716,23.4,1826.4,10,1,1,4,9,5,0,0,0,0,16076,6.8,17418,227,60,-2188,-2716,22.7,1607.6
4520631494,13,14,1,6,2,3,0,0,0,0,16807,7.4,19637,222,57,1295,1167,22.2,1680.7,62,2,0,2,6,2,1,1,0,0,15512,7.2,18470,237,60,-1295,-1167,23.7,1551.2
4438792518,17,2,1,5,2,5,1,1,0,0,16326,7.0,18135,217,60,1697,293,21.7,1632.6,11,1,0,2,5,2,1,0,1,0,14629,6.6,17842,246,40,-1697,-293,24.6,1462.9
4519227071,14,2,0,6,8,4,1,0,1,0,16075,7.0,18425,211,60,-1374,-653,21.1,1607.5,16,5,1,8,6,8,1,1,0,0,17449,7.2,19078,237,43,1374,653,23.7,1744.9
4522402589,14,3,1,7,12,9,0,0,0,0,16000,6.4,16324,190,44,-2111,-2875,19.0,1600.0,16,4,0,12,7,11,0,0,0,0,18111,7.2,19199,221,51,2111,2875,22.1,1811.1
4501831991,13,2,0,8,6,9,0,0,0,0,16880,7.2,18007,217,55,1313,1407,21.7,1688.0,16,2,1,6,8,6,0,0,0,0,15567,6.4,16600,181,52,-1313,-1407,18.1,1556.7
4500814768,22,2,1,6,4,9,1,1,0,0,16231,6.8,17392,222,50,124,-2259,22.2,1623.1,13,3,0,4,6,2,0,0,0,0,16107,7.4,19651,239,68,-124,2259,23.9,1610.7
4518176859,18,7,0,6,9,6,0,0,0,0,16598,6.8,17279,196,64,-1814,-946,19.6,1659.8,20,5,1,9,6,13,1,1,0,0,18412,6.8,18225,231,40,1814,946,23.1,1841.2
4472572307,16,1,0,5,7,4,0,0,0,0,14874,6.6,16128,182,32,-2189,-1838,18.2,1487.4,49,7,1,7,5,7,1,1,0,0,17063,6.8,17966,207,61,2189,1838,20.7,1706.3
4516176117,17,1,0,3,5,1,1,1,0,0,15577,6.8,17552,220,48,-546,-1470,22.0,1557.7,18,4,1,5,3,7,0,0,0,0,16123,7.2,19022,229,52,546,1470,22.9,1612.3
4459193358,13,4,0,4,5,2,1,0,1,0,14366,6.8,17267,207,37,-1614,15,20.7,1436.6,17,0,1,5,4,9,1,1,0,0,15980,7.0,17252,216,62,1614,-15,21.6,1598.0
4502562701,16,2,1,8,7,6,2,1,1,0,17867,7.2,19316,226,76,764,2490,22.6,1786.7,16,3,0,7,8,6,0,0,0,0,17103,6.6,16826,178,59,-764,-2490,17.8,1710.3
4513493153,53,5,1,10,8,10,0,0,0,0,17573,7.0,17180,205,42,-81,-1466,20.5,1757.3,15,7,0,8,10,6,1,1,0,0,17654,7.0,18646,227,57,81,1466,22.7,1765.4
4517801069,38,3,1,9,7,11,1,1,0,0,17869,7.0,17810,205,40,636,-214,20.5,1786.9,14,1,0,7,9,9,0,0,0,0,17233,6.8,18024,215,48,-636,214,21.5,1723.3
4507962860,58,2,1,8,4,7,1,1,0,0,17446,7.0,19285,223,61,2322,1048,22.3,1744.6,14,0,0,4,8,1,0,0,0,0,15124,6.8,18237,222,56,-2322,-1048,22.2,1512.4
4521949489,15,1,0,4,4,4,2,1,1,0,16337,7.0,18992,251,67,1260,1487,25.1,1633.7,35,1,1,4,4,2,0,0,0,0,15077,6.8,17505,204,48,-1260,-1487,20.4,1507.7
4523386766,14,4,0,4,7,6,0,0,0,0,16354,7.0,18778,268,52,-1676,-1759,26.8,1635.4,13,4,1,7,4,8,1,1,0,0,18030,7.4,20537,244,84,1676,1759,24.4,1803.0
4498628249,20,4,1,8,8,12,1,1,0,0,16796,6.6,16424,185,48,700,1221,18.5,1679.6,15,3,0,8,8,14,0,0,0,0,16096,6.2,15203,175,28,-700,-1221,17.5,1609.6
4523793959,20,1,1,8,2,16,1,1,0,0,18186,7.4,19555,232,67,3131,2377,23.2,1818.6,14,2,0,2,8,5,0,0,0,0,15055,6.6,17178,231,50,-3131,-2377,23.1,1505.5
4503435524,35,3,0,2,5,1,0,0,0,0,14616,7.0,18564,242,48,-1441,55,24.2,1461.6,14,2,1,5,2,7,1,1,0,0,16057,6.8,18509,207,67,1441,-55,20.7,1605.7
4467505832,16,0,0,5,11,10,0,0,0,0,16476,7.0,17056,215,52,-1221,-214,21.5,1647.6,14,2,1,11,5,18,1,1,0,0,17697,6.6,17270,186,50,1221,214,18.6,1769.7
4503648979,20,5,1,8,2,7,1,1,0,0,17011,7.2,17776,194,55,2659,2757,19.4,1701.1,39,2,0,2,8,2,0,0,0,0,14352,6.0,15019,201,37,-2659,-2757,20.1,1435.2
4514754903,16,2,1,7,2,10,2,1,1,1,18890,7.2,18772,227,67,4234,1695,22.7,1889.0,58,0,0,2,7,3,0,0,0,0,14656,6.6,17077,214,48,-4234,-1695,21.4,1465.6
4517708245,15,2,1,4,12,7,0,0,0,0,15123,6.6,15874,169,48,-4949,-3427,16.9,1512.3,16,4,0,12,4,14,2,1,1,1,20072,7.2,19301,221,56,4949,3427,22.1,2007.2
4487077116,13,4,0,4,3,5,0,0,0,0,16079,7.0,18772,221,54,752,1388,22.1,1607.9,23,2,1,3,4,5,1,1,0,0,15327,6.6,17384,223,52,-752,-1388,22.3,1532.7
4506389635,15,3,1,6,7,5,0,0,0,0,16940,7.2,17909,246,38,566,-57,24.6,1694.0,16,4,0,7,6,11,0,0,0,0,16374,7.2,17966,219,37,-566,57,21.9,1637.4
4445858545,23,3,1,4,7,6,1,1,0,0,15159,6.6,17115,217,43,-2496,-2174,21.7,1515.9,16,4,0,7,4,6,1,0,1,0,17655,7.2,19289,240,52,2496,2174,24.0,1765.5
4525333513,17,3,0,6,6,2,0,0,0,0,16047,6.8,17256,218,43,-132,-330,21.8,1604.7,15,5,1,6,6,4,2,1,1,0,16179,6.6,17586,218,64,132,330,21.8,1617.9
4505421525,14,3,0,4,9,2,0,0,0,0,14882,6.6,17103,192,36,-5337,-2474,19.2,1488.2,17,2,1,9,4,12,2,1,1,1,20219,7.2,19577,249,56,5337,2474,24.9,2021.9
4526194900,17,2,0,4,3,5,0,0,0,0,15793,6.8,17950,246,40,848,463,24.6,1579.3,49,2,1,3,4,3,1,1,0,0,14945,7.0,17487,210,52,-848,-463,21.0,1494.5
4522058891,11,1,0,5,6,7,0,0,0,0,15334,6.8,17065,193,45,-2412,-2055,19.3,1533.4,16,2,1,6,5,5,0,0,0,0,17746,7.2,19120,243,54,2412,2055,24.3,1774.6
4472857814,18,3,0,5,5,8,1,1,0,0,16498,7.0,18296,259,50,460,183,25.9,1649.8,11,3,1,5,5,7,0,0,0,0,16038,7.0,18113,213,53,-460,-183,21.3,1603.8
4480020751,17,2,1,5,7,3,0,0,0,0,15286,6.6,16864,181,49,-1936,-646,18.1,1528.6,19,5,0,7,5,7,1,1,0,0,17222,7.0,17510,230,42,1936,646,23.0,1722.2
4524546018,43,3,0,5,8,3,0,0,0,0,16344,7.4,19207,230,64,-860,949,23.0,1634.4,13,8,1,8,5,6,1,1,0,0,17204,7.2,18258,202,52,860,-949,20.2,1720.4
4499861575,20,3,1,7,5,8,1,1,0,0,18042,7.0,19223,239,68,2006,346,23.9,1804.2,15,2,0,5,7,4,1,0,1,0,16036,7.2,18877,222,56,-2006,-346,22.2,1603.6
4487946743,15,2,0,7,5,8,1,1,0,0,17049,7.4,20151,223,68,-105,1881,22.3,1704.9,14,3,1,5,7,7,0,0,0,0,17154,7.2,18270,231,41,105,-1881,23.1,1715.4
4522565095,144,3,0,4,4,5,0,0,0,0,17001,7.2,19717,242,61,759,467,24.2,1700.1,10,3,1,4,4,4,0,0,0,0,16242,7.2,19250,242,63,-759,-467,24.2,1624.2
4520745759,12,1,1,13,6,14,2,1,1,0,19234,6.8,17699,179,48,3274,1603,17.9,1923.4,18,2,0,6,13,6,0,0,0,0,15960,6.4,16096,206,40,-3274,-1603,20.6,1596.0
4521579265,17,1,0,3,4,4,0,0,0,0,15158,6.8,17197,236,47,-341,-1982,23.6,1515.8,18,3,1,4,3,5,2,1,1,0,15499,7.0,19179,219,56,341,1982,21.9,1549.9
4527645576,16,0,1,16,2,15,2,1,1,0,20943,7.4,19895,241,52,7847,5766,24.1,2094.3,17,1,0,2,16,2,0,0,0,0,13096,6.0,14129,142,52,-7847,-5766,14.2,1309.6
4482120064,17,1,0,3,7,3,0,0,0,0,15015,6.8,16974,209,53,-1996,-1804,20.9,1501.5,18,3,1,7,3,13,0,0,0,0,17011,7.2,18778,237,51,1996,1804,23.7,1701.1
4526326638,84,3,1,5,7,4,1,1,0,0,16605,7.0,17961,207,69,31,-189,20.7,1660.5,17,2,0,7,5,7,0,0,0,0,16574,7.0,18150,207,63,-31,189,20.7,1657.4
4506000995,19,4,0,3,6,3,0,0,0,0,15676,6.8,17248,267,35,-703,-1216,26.7,1567.6,46,4,1,6,3,8,1,1,0,0,16379,6.8,18464,224,56,703,1216,22.4,1637.9
4525058133,13,6,0,12,8,17,1,1,0,0,19198,6.6,17559,199,46,3024,2225,19.9,1919.8,50,2,1,8,12,15,0,0,0,0,16174,6.4,15334,176,34,-3024,-2225,17.6,1617.4
4523974037,17,17,0,6,5,6,0,0,0,0,16999,7.2,18578,232,59,389,-279,23.2,1699.9,46,3,1,5,6,6,2,1,1,0,16610,7.2,18857,216,64,-389,279,21.6,1661.0
4525555487,14,0,1,4,11,3,0,0,0,0,15294,6.4,16497,202,63,-3442,-2915,20.2,1529.4,13,0,0,11,4,16,0,0,0,0,18736,7.2,19412,221,56,3442,2915,22.1,1873.6
4503380070,12,3,0,6,4,7,0,0,0,0,16438,6.8,16989,203,32,608,-85,20.3,1643.8,19,2,1,4,6,4,1,1,0,0,15830,6.8,17074,206,44,-608,85,20.6,1583.0
4488711535,17,5,1,7,6,10,0,0,0,0,17013,7.4,19131,230,48,447,1096,23.0,1701.3,123,0,0,6,7,5,1,1,0,0,16566,7.0,18035,228,44,-447,-1096,22.8,1656.6
4459102512,15,1,1,9,6,12,0,0,0,0,17027,6.8,17004,175,49,573,48,17.5,1702.7,16,2,0,6,9,11,0,0,0,0,16454,7.0,16956,191,56,-573,-48,19.1,1645.4
4515886739,12,4,0,8,4,15,0,0,0,0,16894,7.2,18333,219,40,1077,1096,21.9,1689.4,16,1,1,4,8,4,0,0,0,0,15817,6.8,17237,208,63,-1077,-1096,20.8,1581.7
4513659077,16,3,0,4,4,3,1,1,0,0,15024,7.0,17340,217,49,-1243,-1261,21.7,1502.4,15,3,1,4,4,6,1,0,1,0,16267,7.0,18601,221,62,1243,1261,22.1,1626.7
4527157118,14,2,0,12,5,10,1,1,0,0,19296,7.4,18995,222,56,3611,2136,22.2,1929.6,15,1,1,5,12,7,0,0,0,0,15685,6.8,16859,180,46,-3611,-2136,18.0,1568.5
4486146372,13,1,0,3,13,4,0,0,0,0,14126,6.4,15246,200,44,-6319,-3391,20.0,1412.6,16,3,1,13,3,22,1,1,0,0,20445,7.2,18637,193,56,6319,3391,19.3,2044.5
4450464581,17,7,1,6,9,7,0,0,0,0,16035,6.6,17041,196,52,-2257,-2894,19.6,1603.5,40,3,0,9,6,5,1,1,0,0,18292,7.4,19935,230,52,2257,2894,23.0,1829.2
4450382199,18,2,1,7,8,7,0,0,0,1,18000,6.8,17798,210,48,1157,-173,21.0,1800.0,56,5,0,8,7,10,0,0,0,0,16843,7.0,17971,190,53,-1157,173,19.0,1684.3
4521488040,32,4,1,9,6,11,0,0,0,0,18508,7.4,19340,239,51,2625,1026,23.9,1850.8,13,18,0,6,9,3,1,0,1,0,15883,7.0,18314,207,51,-2625,-1026,20.7,1588.3
4525341772,17,4,0,8,7,9,1,1,0,0,16786,7.2,19026,244,42,-117,815,24.4,1678.6,16,6,1,7,8,13,1,0,1,0,16903,6.8,18211,223,60,117,-815,22.3,1690.3
4510816810,16,4,1,10,2,7,1,1,0,0,18725,7.2,19463,248,69,4073,1397,24.8,1872.5,18,3,0,2,10,1,0,0,0,0,14652,6.8,18066,225,63,-4073,-1397,22.5,1465.2
4521534899,16,5,1,3,7,5,0,0,0,0,15142,7.0,17554,235,40,-1851,-1813,23.5,1514.2,21,3,0,7,3,9,2,1,1,0,16993,7.2,19367,242,59,1851,1813,24.2,1699.3
4460351665,41,2,1,8,7,15,0,0,0,0,16867,6.8,17923,228,37,150,-446,22.8,1686.7,14,1,0,7,8,5,1,1,0,0,16717,7.2,18369,222,44,-150,446,22.2,1671.7
4524396763,20,2,1,7,9,6,0,0,0,0,16806,6.6,17623,218,49,-369,-1242,21.8,1680.6,14,6,0,9,7,6,1,1,0,0,17175,7.2,18865,200,44,369,1242,20.0,1717.5
4508447638,24,6,1,3,9,4,0,0,0,0,15700,7.0,17393,250,48,-2185,-2444,25.0,1570.0,21,6,0,9,3,9,0,0,0,0,17885,7.6,19837,216,60,2185,2444,21.6,1788.5
4463523266,16,3,1,11,7,14,0,0,0,0,19379,7.0,18120,215,40,3021,347,21.5,1937.9,15,3,0,7,11,8,0,0,0,0,16358,6.8,17773,186,52,-3021,-347,18.6,1635.8
4524697889,25,4,1,5,3,4,1,0,1,0,16788,7.2,19474,264,59,1346,919,26.4,1678.8,39,3,0,3,5,6,1,1,0,0,15442,7.2,18555,242,56,-1346,-919,24.2,1544.2
4505792941,14,1,0,3,6,3,0,0,0,0,14508,6.8,17217,200,48,-3968,-2461,20.0,1450.8,15,1,1,6,3,7,2,1,1,1,18476,7.2,19678,243,76,3968,2461,24.3,1847.6
4524222412,14,2,1,7,7,5,1,1,0,0,16045,6.8,17256,216,48,-282,-79,21.6,1604.5,12,1,0,7,7,9,1,0,1,0,16327,7.0,17335,182,53,282,79,18.2,1632.7
4524622729,15,4,0,6,8,9,0,0,0,0,16116,6.8,17070,196,64,-77,416,19.6,1611.6,14,5,1,8,6,11,1,1,0,0,16193,6.6,16654,204,43,77,-416,20.4,1619.3
4495464440,15,2,0,3,8,4,0,0,0,0,14398,6.6,15990,194,42,-2919,-2318,19.4,1439.8,16,2,1,8,3,9,1,1,0,0,17317,7.0,18308,207,51,2919,2318,20.7,1731.7
4453493719,63,1,1,3,2,2,0,0,0,0,15640,7.0,18748,246,65,77,630,24.6,1564.0,15,4,0,2,3,4,1,1,0,0,15563,7.0,18118,248,62,-77,-630,24.8,1556.3
4518960621,15,2,0,6,8,9,0,0,0,0,17279,6.8,17886,233,36,220,-740,23.3,1727.9,14,1,1,8,6,10,1,1,0,0,17059,7.2,18626,211,56,-220,740,21.1,1705.9
4514425607,17,2,0,7,4,4,1,0,1,0,17994,7.2,20156,269,48,3033,3187,26.9,1799.4,15,2,1,4,7,4,1,1,0,0,14961,6.6,16969,206,44,-3033,-3187,20.6,1496.1
4520362854,36,3,1,3,0,3,0,0,0,0,16248,7.0,18185,239,60,2086,1397,23.9,1624.8,15,4,0,0,3,0,1,1,0,0,14162,6.6,16788,241,56,-2086,-1397,24.1,1416.2
4525028786,17,2,1,4,4,3,1,0,1,0,15222,7.0,18238,228,40,712,1633,22.8,1522.2,14,2,0,4,4,5,1,1,0,0,14510,6.8,16605,198,32,-712,-1633,19.8,1451.0
4522642562,16,3,1,10,7,5,1,1,0,0,17454,6.8,18029,204,58,617,128,20.4,1745.4,12,1,0,7,10,5,0,0,0,0,16837,6.8,17901,178,60,-617,-128,17.8,1683.7
4518093474,17,3,1,8,9,7,1,1,0,0,16527,6.6,16884,194,52,-233,-754,19.4,1652.7,39,6,0,9,8,12,1,0,1,0,16760,6.8,17638,197,38,233,754,19.7,1676.0
4461165597,19,4,0,5,2,5,0,0,0,1,17169,7.0,18362,239,42,1574,1353,23.9,1716.9,18,2,1,2,5,3,2,1,1,0,15595,6.4,17009,252,54,-1574,-1353,25.2,1559.5
4519268347,14,0,0,2,3,3,1,0,1,1,16664,6.8,18036,255,55,1047,-143,25.5,1666.4,14,3,1,3,2,4,1,1,0,0,15617,7.0,18179,247,54,-1047,143,24.7,1561.7
4518851187,15,2,0,1,6,1,0,0,0,0,13427,6.8,16472,211,44,-3175,-1845,21.1,1342.7,16,4,1,6,1,5,1,1,0,0,16602,7.0,18317,217,64,3175,1845,21.7,1660.2
4523452574,16,7,1,6,5,5,1,0,1,0,16953,7.2,18804,238,64,1491,533,23.8,1695.3,21,4,0,5,6,4,1,1,0,0,15462,7.0,18271,213,55,-1491,-533,21.3,1546.2
4518135056,16,5,0,4,11,2,2,1,1,0,14285,6.6,16387,182,52,-4177,-1640,18.2,1428.5,17,4,1,11,4,21,0,0,0,0,18462,7.0,18027,209,45,4177,1640,20.9,1846.2
4510779224,14,2,1,3,7,1,0,0,0,0,15023,7.0,17982,222,60,-2942,-2574,22.2,1502.3,16,4,0,7,3,8,1,1,0,0,17965,7.6,20556,228,72,2942,2574,22.8,1796.5
4521047659,19,2,0,4,3,4,1,1,0,0,16235,7.0,18651,260,58,584,370,26.0,1623.5,16,2,1,3,4,7,0,0,0,0,15651,7.0,18281,221,68,-584,-370,22.1,1565.1
4519356539,38,4,1,3,0,3,0,0,0,0,15984,6.8,18306,261,49,1916,632,26.1,1598.4,16,0,0,0,3,0,0,0,0,0,14068,6.8,17674,224,72,-1916,-632,22.4,1406.8
4458122797,14,2,1,7,2,10,0,0,0,0,17130,7.0,18124,226,47,1931,1567,22.6,1713.0,16,2,0,2,7,4,0,0,0,0,15199,6.8,16557,219,52,-1931,-1567,21.9,1519.9
4480259472,34,18,1,9,4,9,1,1,0,0,19462,7.6,19955,239,68,4444,2813,23.9,1946.2,39,1,0,4,9,3,0,0,0,0,15018,6.6,17142,209,48,-4444,-2813,20.9,1501.8
4519607934,44,3,1,7,5,4,1,1,0,0,16749,7.0,18142,192,60,976,2257,19.2,1674.9,13,2,0,5,7,8,0,0,0,0,15773,6.6,15885,209,35,-976,-2257,20.9,1577.3
4520790076,19,5,1,6,2,9,1,1,0,0,16737,6.8,17593,243,44,2423,295,24.3,1673.7,19,1,0,2,6,2,1,0,1,0,14314,6.8,17298,232,52,-2423,-295,23.2,1431.4
4500906460,14,1,0,1,3,0,0,0,0,0,14351,6.6,17173,218,60,-982,-1614,21.8,1435.1,19,0,1,3,1,2,1,1,0,0,15333,7.4,18787,219,48,982,1614,21.9,1533.3
4496563536,34,3,0,8,8,9,0,0,0,0,16692,7.0,17643,181,68,-795,-117,18.1,1669.2,35,1,1,8,8,14,0,0,0,0,17487,7.0,17760,222,32,795,117,22.2,1748.7
4525985539,13,1,1,11,5,9,0,0,0,0,18590,7.0,18992,215,44,2945,2019,21.5,1859.0,14,1,0,5,11,7,1,0,1,0,15645,6.6,16973,202,48,-2945,-2019,20.2,1564.5
4462552916,16,2,0,2,3,1,0,0,0,0,13581,7.0,17687,201,46,-1885,-366,20.1,1358.1,25,4,1,3,2,5,1,1,0,0,15466,7.2,18053,246,54,1885,366,24.6,1546.6
4522545565,15,1,0,1,6,1,0,0,0,0,14555,6.8,17217,239,48,-1824,-613,23.9,1455.5,19,3,1,6,1,6,1,0,1,0,16379,7.0,17830,204,55,1824,613,20.4,1637.9
4515648647,16,3,1,6,6,5,1,0,1,0,17360,7.4,19151,250,48,1259,1281,25.0,1736.0,19,2,0,6,6,8,1,1,0,0,16101,7.0,17870,201,60,-1259,-1281,20.1,1610.1
4501213837,19,4,0,2,5,2,0,0,0,0,13337,6.4,15472,197,43,-4427,-3299,19.7,1333.7,15,6,1,5,2,5,1,1,0,1,17764,7.2,18771,236,48,4427,3299,23.6,1776.4
4527045215,57,6,0,5,6,5,2,1,1,0,14875,6.8,17019,194,48,-1641,-602,19.4,1487.5,17,4,1,6,5,5,0,0,0,0,16516,6.8,17621,217,44,1641,602,21.7,1651.6
4526935015,15,6,1,6,3,5,1,1,0,0,16638,7.2,18824,212,67,1402,1512,21.2,1663.8,21,2,0,3,6,3,0,0,0,0,15236,6.8,17312,230,52,-1402,-1512,23.0,1523.6
4522113197,13,2,1,3,4,1,1,1,0,0,14664,6.8,16863,218,41,-1770,-1276,21.8,1466.4,18,2,0,4,3,4,1,0,1,0,16434,7.0,18139,219,63,1770,1276,21.9,1643.4
4507747871,18,1,1,6,5,6,0,0,0,0,16471,6.8,17952,246,36,1450,763,24.6,1647.1,18,2,0,5,6,3,0,0,0,0,15021,6.8,17189,200,40,-1450,-763,20.0,1502.1
4477479713,17,1,1,10,3,8,1,1,0,0,18463,7.4,19599,248,40,3002,2125,24.8,1846.3,10,2,0,3,10,3,1,0,1,0,15461,6.8,17474,218,58,-3002,-2125,21.8,1546.1
4462628331,13,6,1,7,11,8,0,0,0,0,16749,6.8,17223,226,47,-2320,-1204,22.6,1674.9,37,2,0,11,7,12,2,1,1,0,19069,6.8,18427,207,60,2320,1204,20.7,1906.9
4489371310,12,0,0,1,6,0,0,0,0,0,13977,6.6,17736,208,60,-4097,-1658,20.8,1397.7,31,1,1,6,1,7,0,0,0,0,18074,7.2,19394,226,72,4097,1658,22.6,1807.4
4426908175,13,1,0,6,2,4,0,0,0,0,15828,6.8,17834,218,48,1176,763,21.8,1582.8,16,1,1,2,6,2,1,1,0,0,14652,6.8,17071,218,49,-1176,-763,21.8,1465.2
4524583586,13,1,0,4,6,2,0,0,0,0,14687,6.6,16647,216,32,-2142,-1742,21.6,1468.7,17,1,1,6,4,5,1,1,0,0,16829,6.8,18389,223,75,2142,1742,22.3,1682.9
4492188937,37,1,1,5,3,6,1,1,0,0,16871,7.4,19422,213,71,1308,1371,21.3,1687.1,12,2,0,3,5,5,0,0,0,0,15563,7.0,18051,210,64,-1308,-1371,21.0,1556.3
4489966675,27,2,1,5,5,6,0,0,0,0,16281,6.8,17527,233,48,128,-368,23.3,1628.1,17,4,0,5,5,10,1,1,0,0,16153,7.2,17895,223,51,-128,368,22.3,1615.3
4495892893,16,5,0,5,9,5,1,1,0,1,17087,6.8,17225,206,44,-988,-1321,20.6,1708.7,59,3,1,9,5,8,1,0,1,1,18075,7.2,18546,201,39,988,1321,20.1,1807.5
4521663948,16,3,0,10,5,13,1,1,0,0,18287,7.2,18402,213,52,2242,727,21.3,1828.7,36,1,1,5,10,3,0,0,0,0,16045,6.8,17675,225,47,-2242,-727,22.5,1604.5
4519189625,16,0,1,6,1,7,0,0,0,0,16602,7.2,19275,246,54,2919,2298,24.6,1660.2,12,1,0,1,6,0,0,0,0,0,13683,6.6,16977,214,41,-2919,-2298,21.4,1368.3
4513824717,18,5,0,6,3,7,0,0,0,0,16485,7.0,18759,222,44,1097,711,22.2,1648.5,14,1,1,3,6,1,1,1,0,0,15388,7.0,18048,240,63,-1097,-711,24.0,1538.8
4477116393,14,2,0,4,6,5,0,0,0,0,16414,6.8,18297,247,62,-58,-1047,24.7,1641.4,16,3,1,6,4,2,1,1,0,0,16472,7.0,19344,244,60,58,1047,24.4,1647.2
4413670399,20,3,0,9,8,14,1,1,0,0,17494,6.8,17832,201,44,14,202,20.1,1749.4,17,3,1,8,9,9,0,0,0,0,17480,7.0,17630,243,44,-14,-202,24.3,1748.0
4518026363,17,0,1,15,7,15,1,1,0,1,21755,7.2,18071,191,48,5494,1987,19.1,2175.5,10,2,0,7,15,7,0,0,0,0,16261,6.4,16084,168,44,-5494,-1987,16.8,1626.1
4455245413,14,1,1,5,10,4,0,0,0,0,15985,6.8,17576,223,47,-974,-1978,22.3,1598.5,13,3,0,10,5,11,1,1,0,0,16959,7.2,19554,188,37,974,1978,18.8,1695.9
4483586875,13,0,1,12,6,13,1,1,0,0,18704,7.4,19748,223,56,2765,2798,22.3,1870.4,30,1,0,6,12,5,0,0,0,0,15939,6.8,16950,233,42,-2765,-2798,23.3,1593.9
4526112054,14,3,0,2,5,3,1,1,0,0,14606,7.0,17820,221,65,-1605,237,22.1,1460.6,23,2,1,5,2,7,0,0,0,0,16211,7.0,17583,235,44,1605,-237,23.5,1621.1
4517907047,16,1,1,4,10,3,0,0,0,0,15419,6.4,17517,191,43,-2636,-839,19.1,1541.9,14,2,0,10,4,9,0,0,0,0,18055,6.8,18356,225,48,2636,839,22.5,1805.5
4434566709,15,5,1,7,1,10,0,0,0,0,17558,7.2,19554,251,51,2704,1740,25.1,1755.8,16,2,0,1,7,1,1,1,0,0,14854,6.6,17814,224,72,-2704,-1740,22.4,1485.4
4518730282,15,1,1,3,9,3,0,0,0,0,14881,6.4,15603,195,64,-1683,-377,19.5,1488.1,15,4,0,9,3,17,1,1,0,0,16564,6.4,15980,185,55,1683,377,18.5,1656.4
4518254989,14,2,1,3,7,3,0,0,0,0,14936,6.6,16574,225,30,-1703,-2550,22.5,1493.6,19,2,0,7,3,7,0,0,0,0,16639,7.2,19124,221,48,1703,2550,22.1,1663.9
4467234641,18,5,1,7,7,6,0,0,0,0,16119,6.6,16658,217,41,-524,-1029,21.7,1611.9,23,5,0,7,7,8,2,1,1,0,16643,6.8,17687,190,50,524,1029,19.0,1664.3
4479961520,14,2,0,5,4,4,0,0,0,0,16656,7.2,18582,252,42,930,275,25.2,1665.6,13,3,1,4,5,6,0,0,0,0,15726,7.2,18307,205,48,-930,-275,20.5,1572.6
4478159300,16,5,0,5,1,5,1,1,0,0,16352,7.2,19028,250,52,1824,1204,25.0,1635.2,20,4,1,1,5,2,0,0,0,0,14528,7.0,17824,239,52,-1824,-1204,23.9,1452.8
4522484818,16,2,1,8,8,8,0,0,0,0,17698,7.2,18605,218,56,-373,-1526,21.8,1769.8,14,2,0,8,8,5,1,1,0,0,18071,7.4,20131,233,76,373,1526,23.3,1807.1
4527696871,36,2,1,9,4,11,1,1,0,0,18503,7.4,19717,250,56,2527,1695,25.0,1850.3,26,16,0,4,9,9,0,0,0,0,15976,7.0,18022,210,63,-2527,-1695,21.0,1597.6
4516653257,17,3,1,6,8,7,1,1,0,0,16006,6.8,17612,233,47,-1493,-1266,23.3,1600.6,16,4,0,8,6,11,0,0,0,0,17499,7.0,18878,247,36,1493,1266,24.7,1749.9
4445986200,12,1,0,9,6,14,0,0,0,0,17385,7.0,18061,208,36,978,372,20.8,1738.5,18,3,1,6,9,7,1,0,1,0,16407,7.0,17689,226,54,-978,-372,22.6,1640.7
4500199178,16,2,0,5,8,6,1,0,1,0,15717,6.6,16971,196,60,-646,-960,19.6,1571.7,16,3,1,8,5,8,1,1,0,0,16363,6.8,17931,222,31,646,960,22.2,1636.3
4492532758,13,4,0,4,7,3,0,0,0,0,15333,7.0,18073,201,68,-1942,57,20.1,1533.3,18,3,1,7,4,5,1,1,0,0,17275,6.8,18016,236,48,1942,-57,23.6,1727.5
4520650769,18,2,0,4,3,3,0,0,0,0,15220,6.8,18562,234,44,-1297,-129,23.4,1522.0,34,1,1,3,4,4,0,0,0,0,16517,7.0,18691,241,56,1297,129,24.1,1651.7
4518693297,14,0,0,6,7,9,0,0,0,0,16060,6.6,16426,187,50,-1776,-3265,18.7,1606.0,14,1,1,7,6,7,0,0,0,0,17836,7.2,19691,248,60,1776,3265,24.8,1783.6
4527082240,17,1,1,4,1,5,2,1,1,0,16973,7.2,19798,271,72,2420,2428,27.1,1697.3,12,4,0,1,4,2,0,0,0,0,14553,6.6,17370,247,48,-2420,-2428,24.7,1455.3
4512800832,14,2,0,3,6,3,0,0,0,0,14901,6.8,16728,201,48,-1123,-976,20.1,1490.1,18,1,1,6,3,6,1,1,0,0,16024,6.8,17704,232,36,1123,976,23.2,1602.4
4521892508,16,4,1,4,8,4,1,1,0,0,15651,6.8,16945,201,48,-1990,-3002,20.1,1565.1,39,1,0,8,4,6,0,0,0,0,17641,7.4,19947,226,56,1990,3002,22.6,1764.1
4489508995,16,3,0,4,11,2,0,0,0,0,15515,6.8,17838,231,50,-2272,-2400,23.1,1551.5,34,4,1,11,4,7,1,1,0,0,17787,7.6,20238,225,44,2272,2400,22.5,1778.7
4523645725,15,3,0,3,6,3,0,0,0,0,15736,6.8,18798,232,72,-259,555,23.2,1573.6,15,2,1,6,3,5,2,1,1,0,15995,6.8,18243,220,48,259,-555,22.0,1599.5
4484098460,83,3,0,6,6,2,1,1,0,0,16995,7.6,19978,241,64,-418,185,24.1,1699.5,14,1,1,6,6,8,0,0,0,0,17413,7.4,19793,237,73,418,-185,23.7,1741.3
4525845524,13,3,0,5,4,10,0,0,0,0,16386,7.2,18530,218,56,-167,309,21.8,1638.6,12,1,1,4,5,3,1,0,1,0,16553,7.0,18221,230,49,167,-309,23.0,1655.3
4505104958,19,1,0,2,3,2,1,1,0,0,14273,6.8,17164,220,40,-814,-418,22.0,1427.3,11,2,1,3,2,2,1,0,1,0,15087,6.6,17582,224,44,814,418,22.4,1508.7
4522690291,12,1,1,7,5,7,1,0,1,0,16426,6.8,17766,187,46,846,-1893,18.7,1642.6,13,2,0,5,7,0,1,1,0,0,15580,7.4,19659,231,61,-846,1893,23.1,1558.0
4478470273,20,4,1,5,10,8,2,1,1,0,15156,6.4,16017,156,53,-2997,-3052,15.6,1515.6,29,7,0,10,5,5,0,0,0,0,18153,7.0,19069,222,49,2997,3052,22.2,1815.3
4466252369,12,2,1,5,6,4,1,0,1,0,16103,7.2,18747,208,55,-2659,88,20.8,1610.3,16,1,0,6,5,11,0,0,0,1,18762,7.4,18659,245,52,2659,-88,24.5,1876.2
4500758872,11,0,0,4,8,6,0,0,0,0,14327,6.6,16104,194,30,-3392,-2116,19.4,1432.7,15,2,1,8,4,7,1,1,0,0,17719,6.8,18220,223,41,3392,2116,22.3,1771.9
4459480413,15,1,0,4,6,5,0,0,0,0,15506,6.8,17710,231,50,-672,-1420,23.1,1550.6,12,1,1,6,4,4,1,1,0,0,16178,7.2,19130,214,49,672,1420,21.4,1617.8
4517786912,14,3,1,5,7,6,2,1,1,0,15157,6.8,17194,218,38,-1301,-502,21.8,1515.7,14,2,0,7,5,8,0,0,0,0,16458,7.0,17696,209,52,1301,502,20.9,1645.8
4458968842,13,3,0,7,10,6,1,0,1,0,16861,6.8,17932,184,35,-1255,-254,18.4,1686.1,85,1,1,10,7,10,0,0,0,0,18116,7.2,18186,195,48,1255,254,19.5,1811.6
4512162103,13,5,0,5,7,4,0,0,0,0,15196,6.4,16908,191,48,-1707,-1286,19.1,1519.6,62,3,1,7,5,10,1,1,0,0,16903,7.0,18194,216,51,1707,1286,21.6,1690.3
4517907839,12,3,1,15,5,18,1,1,0,1,20844,7.2,18777,250,39,6672,3761,25.0,2084.4,22,1,0,5,15,4,1,0,1,0,14172,6.0,15016,171,44,-6672,-3761,17.1,1417.2
4521090757,110,3,0,2,3,5,0,0,0,0,15186,7.2,18537,236,67,-35,1112,23.6,1518.6,19,3,1,3,2,4,0,0,0,0,15221,6.8,17425,236,48,35,-1112,23.6,1522.1
4502539772,14,2,1,3,8,6,0,0,0,0,15193,6.8,17054,232,57,-1810,-2661,23.2,1519.3,16,0,0,8,3,2,1,1,0,0,17003,7.0,19715,235,65,1810,2661,23.5,1700.3
4477737633,17,2,0,6,14,8,0,0,0,0,15729,6.6,16459,186,30,-5830,-3608,18.6,1572.9,17,4,1,14,6,14,1,0,1,1,21559,7.4,20067,225,56,5830,3608,22.5,2155.9
4520358684,14,5,0,8,5,9,1,1,0,0,16753,6.8,18557,233,40,204,-830,23.3,1675.3,13,3,1,5,8,4,1,0,1,0,16549,7.2,19387,217,52,-204,830,21.7,1654.9
4497467967,14,3,1,8,6,7,0,0,0,0,16451,6.6,16842,191,34,359,-772,19.1,1645.1,38,2,0,6,8,6,0,0,0,0,16092,7.0,17614,195,51,-359,772,19.5,1609.2
4521484039,11,1,1,4,2,3,0,0,0,0,15270,6.8,17913,225,44,-375,-1283,22.5,1527.0,9,1,0,2,4,1,1,1,0,0,15645,7.4,19196,207,88,375,1283,20.7,1564.5
4469793505,15,2,0,6,3,9,0,0,0,0,16568,7.2,18645,197,52,1188,2039,19.7,1656.8,20,2,1,3,6,4,2,1,1,0,15380,6.8,16606,207,52,-1188,-2039,20.7,1538.0
4482519172,52,4,0,10,4,15,1,1,0,0,18501,7.6,19714,230,64,2907,2700,23.0,1850.1,12,0,1,4,10,6,0,0,0,0,15594,7.0,17014,215,55,-2907,-2700,21.5,1559.4
4450708282,13,2,0,11,4,9,1,0,1,0,17666,7.4,19949,218,45,2405,3251,21.8,1766.6,16,3,1,4,11,4,1,1,0,0,15261,6.6,16698,204,45,-2405,-3251,20.4,1526.1
4497800773,19,3,1,4,7,6,1,1,0,0,14582,6.4,16375,214,37,-2298,-2281,21.4,1458.2,13,3,0,7,4,7,0,0,0,0,16880,7.0,18656,213,53,2298,2281,21.3,1688.0
4503345780,12,3,1,4,2,5,0,0,0,0,16164,7.2,19020,246,46,956,-27,24.6,1616.4,59,1,0,2,4,3,1,1,0,0,15208,7.2,19047,242,73,-956,27,24.2,1520.8
4527658739,16,3,0,5,7,6,1,0,1,2,18075,7.2,19324,233,60,600,289,23.3,1807.5,37,4,1,7,5,6,1,1,0,0,17475,7.0,19035,224,63,-600,-289,22.4,1747.5
4525232223,17,5,1,9,5,8,0,0,0,0,17757,7.0,18821,217,48,2341,2225,21.7,1775.7,18,3,0,5,9,5,1,1,0,0,15416,6.8,16596,185,58,-2341,-2225,18.5,1541.6
4527509662,17,2,1,7,2,8,1,1,0,0,17359,7.0,18203,219,65,3098,1882,21.9,1735.9,14,2,0,2,7,1,1,0,1,0,14261,6.4,16321,213,36,-3098,-1882,21.3,1426.1
4521806282,16,0,1,8,6,4,0,0,0,0,16818,7.0,18842,213,52,588,1104,21.3,1681.8,12,0,0,6,8,7,1,1,0,0,16230,7.0,17738,232,45,-588,-1104,23.2,1623.0
4526476556,15,3,1,7,6,6,0,0,0,0,16946,7.4,19649,221,76,714,1650,22.1,1694.6,12,5,0,6,7,7,0,0,0,0,16232,6.8,17999,215,58,-714,-1650,21.5,1623.2
4511803387,17,2,0,8,8,5,0,0,0,0,16918,6.8,18396,216,60,355,-336,21.6,1691.8,18,2,1,8,8,6,1,1,0,0,16563,6.8,18732,214,44,-355,336,21.4,1656.3
4520844282,14,0,0,6,9,9,0,0,0,0,16240,7.2,18554,205,68,-2184,-1298,20.5,1624.0,85,1,1,9,6,9,1,1,0,0,18424,7.2,19852,250,56,2184,1298,25.0,1842.4
4520873803,15,1,0,3,7,5,1,0,1,1,16886,7.0,17965,244,53,75,616,24.4,1688.6,18,0,1,7,3,14,1,1,0,0,16811,7.0,17349,195,60,-75,-616,19.5,1681.1
4509363345,40,2,1,6,8,9,0,0,0,0,16185,6.8,17924,204,40,-2100,-925,20.4,1618.5,14,20,0,8,6,12,2,1,1,1,18285,7.0,18849,199,40,2100,925,19.9,1828.5
4521386660,15,1,1,4,4,1,0,0,0,0,14881,7.0,18074,209,45,-856,-563,20.9,1488.1,164,3,0,4,4,1,0,0,0,0,15737,7.0,18637,236,55,856,563,23.6,1573.7
4521025798,14,2,0,4,3,3,1,1,0,0,16374,7.0,18573,263,57,825,1066,26.3,1637.4,15,5,1,3,4,6,0,0,0,0,15549,6.6,17507,253,46,-825,-1066,25.3,1554.9
4459084553,21,7,0,5,5,6,0,0,0,0,16110,6.8,17732,245,38,-1519,-1488,24.5,1611.0,20,5,1,5,5,10,1,1,0,0,17629,7.2,19220,228,76,1519,1488,22.8,1762.9
4527366707,18,2,0,7,2,10,0,0,0,0,16879,7.2,18526,211,52,2053,1126,21.1,1687.9,15,3,1,2,7,3,1,1,0,0,14826,6.8,17400,232,64,-2053,-1126,23.2,1482.6
4517995576,37,2,1,6,5,5,1,0,1,0,16490,6.8,17576,225,48,-508,-1394,22.5,1649.0,15,2,0,5,6,3,1,1,0,0,16998,7.2,18970,257,72,508,1394,25.7,1699.8
4526586173,17,1,0,6,4,5,0,0,0,0,16819,7.0,18039,244,54,1621,128,24.4,1681.9,18,2,1,4,6,2,1,1,0,0,15198,6.8,17911,219,55,-1621,-128,21.9,1519.8
4523576298,14,4,1,8,3,7,1,1,0,0,16595,7.2,18940,210,55,859,2681,21.0,1659.5,21,1,0,3,8,7,0,0,0,0,15736,6.4,16259,203,39,-859,-2681,20.3,1573.6
4472405035,39,2,1,7,6,9,1,1,0,0,17079,7.0,17964,212,44,-365,855,21.2,1707.9,17,3,0,6,7,10,0,0,0,0,17444,6.8,17109,238,44,365,-855,23.8,1744.4
4505590856,74,4,1,3,2,7,0,0,0,0,14452,6.8,16280,202,40,47,-264,20.2,1445.2,16,0,0,2,3,2,1,1,0,0,14405,6.6,16544,226,48,-47,264,22.6,1440.5
4487526235,17,1,0,4,5,4,0,0,0,0,16194,6.8,17871,238,76,376,-194,23.8,1619.4,19,4,1,5,4,10,2,1,1,0,15818,7.0,18065,215,52,-376,194,21.5,1581.8
4407710029,13,0,1,8,4,10,1,0,1,0,17938,7.0,18626,239,51,3117,1580,23.9,1793.8,13,0,0,4,8,1,1,1,0,0,14821,6.8,17046,196,44,-3117,-1580,19.6,1482.1
4509989116,19,3,1,5,8,6,0,0,0,0,16020,6.8,17044,240,46,-1407,-1305,24.0,1602.0,25,7,0,8,5,12,1,1,0,0,17427,7.2,18349,226,50,1407,1305,22.6,1742.7
4517522957,25,3,1,4,8,7,0,0,0,0,14627,6.6,16086,193,47,-3960,-4005,19.3,1462.7,16,8,0,8,4,9,1,1,0,0,18587,7.6,20091,247,68,3960,4005,24.7,1858.7
4517507024,18,6,0,5,6,6,1,1,0,0,15826,6.8,17837,235,52,-1177,-1157,23.5,1582.6,18,4,1,6,5,4,0,0,0,0,17003,7.4,18994,242,49,1177,1157,24.2,1700.3
4520335431,18,1,1,8,2,8,1,1,0,0,18433,7.2,19855,237,54,4759,3279,23.7,1843.3,10,1,0,2,8,3,1,0,1,0,13674,6.6,16576,183,44,-4759,-3279,18.3,1367.4
4505797125,15,1,1,9,5,9,0,0,0,1,18391,6.6,17080,183,43,2040,725,18.3,1839.1,16,0,0,5,9,3,1,0,1,1,16351,6.6,16355,203,44,-2040,-725,20.3,1635.1
4521220052,14,1,1,7,4,2,1,1,0,0,15924,7.0,17965,211,45,961,1114,21.1,1592.4,13,2,0,4,7,3,0,0,0,0,14963,6.6,16851,199,38,-961,-1114,19.9,1496.3
4523056452,16,2,0,7,5,6,1,1,0,0,16580,7.0,17570,207,36,-334,-1403,20.7,1658.0,15,4,1,5,7,5,0,0,0,0,16914,7.0,18973,228,56,334,1403,22.8,1691.4
4522528300,20,3,0,4,3,5,1,1,0,0,15562,7.2,18694,235,62,-526,496,23.5,1556.2,15,4,1,3,4,2,0,0,0,0,16088,7.0,18198,219,63,526,-496,21.9,1608.8
4464639816,48,3,0,3,7,0,0,0,0,0,14467,7.0,17728,220,58,-2287,-735,22.0,1446.7,16,3,1,7,3,6,1,1,0,0,16754,7.0,18463,218,40,2287,735,21.8,1675.4
4517169650,26,3,0,2,5,5,0,0,0,0,14531,6.8,16999,222,56,-1711,-2183,22.2,1453.1,15,4,1,5,2,5,1,1,0,0,16242,7.2,19182,235,52,1711,2183,23.5,1624.2
4524773384,18,0,0,7,7,10,1,1,0,0,16585,6.8,16982,191,42,-536,-864,19.1,1658.5,17,1,1,7,7,9,0,0,0,0,17121,6.8,17846,234,52,536,864,23.4,1712.1
4522480570,12,3,1,7,6,6,0,0,0,0,17197,7.2,18196,238,45,1125,-141,23.8,1719.7,38,0,0,6,7,6,0,0,0,0,16072,7.0,18337,205,65,-1125,141,20.5,1607.2
4486384947,21,4,1,5,4,11,0,0,0,0,16282,6.8,17378,213,49,882,512,21.3,1628.2,19,3,0,4,5,3,2,1,1,0,15400,6.6,16866,228,52,-882,-512,22.8,1540.0
4515904262,17,1,0,8,7,7,0,0,0,0,17908,7.2,19202,229,54,653,430,22.9,1790.8,12,2,1,7,8,9,1,1,0,0,17255,7.2,18772,247,46,-653,-430,24.7,1725.5
4494865668,19,4,1,4,3,1,1,0,1,0,15454,6.6,17213,226,49,957,406,22.6,1545.4,16,3,0,3,4,3,0,0,0,0,14497,6.8,16807,215,50,-957,-406,21.5,1449.7
4525170767,16,4,0,14,10,23,0,0,0,0,19139,6.8,17648,180,28,814,82,18.0,1913.9,19,3,1,10,14,14,0,0,0,0,18325,7.0,17566,203,46,-814,-82,20.3,1832.5
4512246178,23,3,1,11,5,6,2,1,1,1,20151,7.4,20475,261,72,4296,3034,26.1,2015.1,17,0,0,5,11,9,0,0,0,0,15855,6.8,17441,173,75,-4296,-3034,17.3,1585.5
4518106435,16,1,0,0,4,0,0,0,0,0,14052,6.6,16542,229,48,-2502,-3183,22.9,1405.2,38,4,1,4,0,4,0,0,0,0,16554,7.0,19725,249,60,2502,3183,24.9,1655.4
4495178301,19,3,1,4,3,7,0,0,0,0,15989,6.8,17682,254,48,-77,-1515,25.4,1598.9,15,4,0,3,4,3,2,1,1,0,16066,7.0,19197,250,74,77,1515,25.0,1606.6
4526022064,17,3,0,6,2,10,1,1,0,0,17066,7.0,18756,230,61,1998,1200,23.0,1706.6,13,3,1,2,6,2,0,0,0,0,15068,6.8,17556,253,48,-1998,-1200,25.3,1506.8
4439533081,14,1,0,4,4,6,1,0,1,0,16180,6.8,17769,217,56,1338,1039,21.7,1618.0,15,3,1,4,4,3,0,0,0,0,14842,6.6,16730,216,47,-1338,-1039,21.6,1484.2
4451694219,24,0,0,1,5,0,0,0,0,0,14824,7.2,18421,230,72,-1424,-2416,23.0,1482.4,14,2,1,5,1,3,1,1,0,0,16248,7.6,20837,228,68,1424,2416,22.8,1624.8
4486987445,16,2,0,3,3,2,1,0,1,0,15416,6.8,17935,228,61,450,-9,22.8,1541.6,12,2,1,3,3,5,0,0,0,0,14966,6.8,17944,220,53,-450,9,22.0,1496.6
4515601769,12,5,1,9,8,7,0,0,0,0,17670,7.0,18217,201,72,32,-952,20.1,1767.0,20,1,0,8,9,9,0,0,0,0,17638,7.4,19169,247,52,-32,952,24.7,1763.8
4495034271,22,3,0,3,9,4,0,0,0,0,14930,6.6,16710,222,36,-1844,-1368,22.2,1493.0,37,4,1,9,3,9,1,1,0,0,16774,6.8,18078,212,36,1844,1368,21.2,1677.4
4510187946,12,3,0,1,5,2,0,0,0,0,14257,6.6,17053,230,44,-3234,-2889,23.0,1425.7,17,3,1,5,1,9,0,0,0,0,17491,7.2,19942,247,68,3234,2889,24.7,1749.1
4525783295,14,0,0,9,5,6,1,1,0,0,18912,7.4,20086,244,70,3970,2818,24.4,1891.2,10,0,1,5,9,5,0,0,0,0,14942,6.6,17268,210,29,-3970,-2818,21.0,1494.2
4476242451,13,1,0,4,4,1,0,0,0,0,15169,6.8,18276,208,70,585,2037,20.8,1516.9,57,4,1,4,4,5,0,0,0,0,14584,6.4,16239,196,43,-585,-2037,19.6,1458.4
4513108171,14,1,1,8,7,8,1,0,1,0,17562,6.8,18086,203,49,1269,739,20.3,1756.2,14,2,0,7,8,9,1,1,0,0,16293,6.8,17347,199,48,-1269,-739,19.9,1629.3
4526837862,14,2,1,4,7,6,1,0,1,0,15289,7.0,16623,210,52,-1041,-1114,21.0,1528.9,10,1,0,7,4,5,1,1,0,0,16330,6.8,17737,196,52,1041,1114,19.6,1633.0
4510540310,68,3,0,7,3,7,1,0,1,0,16498,7.2,18955,219,60,468,2091,21.9,1649.8,178,2,1,3,7,4,0,0,0,0,16030,6.6,16864,237,64,-468,-2091,23.7,1603.0
4515649293,13,1,1,4,8,8,0,0,0,0,15352,6.4,15672,193,46,-1702,-1490,19.3,1535.2,15,1,0,8,4,13,1,1,0,0,17054,6.6,17162,191,44,1702,1490,19.1,1705.4
4452983788,22,7,0,7,8,9,0,0,0,0,17543,7.2,18967,246,48,-144,-867,24.6,1754.3,53,5,1,8,7,10,2,1,1,0,17687,7.4,19834,225,64,144,867,22.5,1768.7
4509882748,16,1,1,7,6,9,0,0,0,0,17048,6.6,16378,227,52,1453,-254,22.7,1704.8,18,1,0,6,7,4,0,0,0,0,15595,6.6,16632,188,53,-1453,254,18.8,1559.5
4513103663,14,2,0,4,9,4,0,0,0,0,14743,6.4,15965,197,50,-3465,-3351,19.7,1474.3,20,3,1,9,4,10,1,1,0,0,18208,7.4,19316,224,74,3465,3351,22.4,1820.8
4470179488,16,4,0,4,6,5,0,0,0,0,15403,6.8,17661,216,43,-1636,-2200,21.6,1540.3,15,3,1,6,4,5,1,1,0,0,17039,7.2,19861,245,60,1636,2200,24.5,1703.9
4515829402,105,1,1,6,7,3,0,0,0,0,15720,6.8,17660,187,43,-1862,-1326,18.7,1572.0,13,3,0,7,6,6,1,0,1,0,17582,7.2,18986,240,52,1862,1326,24.0,1758.2
4520816050,16,7,1,9,3,8,2,1,1,0,17577,7.4,20010,210,64,2812,2747,21.0,1757.7,16,3,0,3,9,4,0,0,0,0,14765,6.8,17263,205,56,-2812,-2747,20.5,1476.5
4526469771,45,4,1,14,5,22,0,0,0,0,19551,7.2,18331,198,43,2896,2001,19.8,1955.1,13,5,0,5,14,6,0,0,0,0,16655,6.6,16330,228,35,-2896,-2001,22.8,1665.5
4500655120,18,0,0,2,6,1,1,1,0,0,14555,6.6,16722,232,44,-2459,-2110,23.2,1455.5,61,6,1,6,2,10,0,0,0,0,17014,7.2,18832,243,60,2459,2110,24.3,1701.4
4476068972,17,1,1,3,4,4,0,0,0,0,15478,6.8,17551,233,59,-1003,-1571,23.3,1547.8,16,0,0,4,3,4,0,0,0,0,16481,7.2,19122,236,64,1003,1571,23.6,1648.1
4502350951,16,2,1,3,7,2,1,1,0,0,14857,6.6,17267,228,57,-2748,-2417,22.8,1485.7,16,1,0,7,3,8,1,0,1,0,17605,7.4,19684,208,64,2748,2417,20.8,1760.5
4465455214,16,4,1,7,8,8,1,1,0,0,17112,7.0,18050,215,52,-975,-678,21.5,1711.2,15,5,0,8,7,10,1,0,1,0,18087,7.0,18728,225,68,975,678,22.5,1808.7
4462311511,36,4,1,1,6,2,0,0,0,0,13981,6.6,16753,220,52,-2494,-996,22.0,1398.1,14,2,0,6,1,3,0,0,0,0,16475,6.8,17749,250,44,2494,996,25.0,1647.5
4494726186,11,4,0,4,6,3,0,0,0,0,15727,7.2,18903,247,44,-84,221,24.7,1572.7,14,1,1,6,4,4,0,0,0,0,15811,7.2,18682,216,52,84,-221,21.6,1581.1
4459430310,14,4,0,0,5,0,1,0,1,0,13776,6.8,16664,218,60,-2765,-2677,21.8,1377.6,19,3,1,5,0,6,1,1,0,0,16541,7.2,19341,256,53,2765,2677,25.6,1654.1
4513668536,15,2,1,3,7,3,1,1,0,0,15495,7.0,17827,226,60,-1972,-1613,22.6,1549.5,29,3,0,7,3,9,0,0,0,0,17467,7.2,19440,233,62,1972,1613,23.3,1746.7
4378541993,16,1,1,5,4,2,0,0,0,0,15215,6.6,16664,212,41,0,-368,21.2,1521.5,37,1,0,4,5,5,1,1,0,0,15215,6.8,17032,197,55,0,368,19.7,1521.5
4518035441,17,0,0,4,7,4,2,1,1,0,15132,6.8,16489,190,64,-2022,-2023,19.0,1513.2,14,2,1,7,4,7,0,0,0,0,17154,7.2,18512,242,44,2022,2023,24.2,1715.4
4519154901,16,1,1,2,6,0,0,0,0,0,14072,6.6,16596,207,56,-2186,-1093,20.7,1407.2,37,1,0,6,2,7,1,1,0,0,16258,7.0,17689,210,54,2186,1093,21.0,1625.8
4520700256,17,1,0,4,7,3,0,0,0,0,15504,7.0,17911,222,47,-1471,-1204,22.2,1550.4,15,6,1,7,4,10,1,1,0,0,16975,7.0,19115,214,50,1471,1204,21.4,1697.5
4524440792,15,4,0,3,6,4,0,0,0,0,14879,6.6,16931,217,35,-1775,-722,21.7,1487.9,35,3,1,6,3,4,0,0,0,0,16654,6.8,17653,215,56,1775,722,21.5,1665.4
4478188896,20,2,1,6,4,5,1,1,0,0,16588,7.2,19189,229,62,1782,1959,22.9,1658.8,17,2,0,4,6,1,1,0,1,0,14806,6.8,17230,189,44,-1782,-1959,18.9,1480.6
4490954687,57,2,1,8,5,7,1,0,1,0,16776,7.0,18113,207,64,907,-86,20.7,1677.6,18,2,0,5,8,8,1,1,0,0,15869,7.0,18199,228,42,-907,86,22.8,1586.9
4525839083,35,3,1,10,5,9,2,1,1,1,19439,7.4,19736,244,50,3863,2639,24.4,1943.9,17,2,0,5,10,5,0,0,0,0,15576,6.6,17097,197,49,-3863,-2639,19.7,1557.6
4483907436,16,3,0,4,11,5,1,0,1,1,16855,6.6,16360,232,40,-885,-2172,23.2,1685.5,37,1,1,11,4,15,1,1,0,0,17740,7.2,18532,216,36,885,2172,21.6,1774.0
4527241479,90,2,0,7,6,8,0,0,0,0,16224,7.0,18263,189,45,-376,1005,18.9,1622.4,13,3,1,6,7,7,1,1,0,0,16600,6.6,17258,220,45,376,-1005,22.0,1660.0
4497099523,58,2,0,9,10,10,2,1,1,0,18368,7.2,19062,204,52,-328,137,20.4,1836.8,14,1,1,10,9,13,0,0,0,0,18696,7.2,18925,230,52,328,-137,23.0,1869.6
4525620906,15,3,0,4,7,2,0,0,0,0,15547,6.8,18141,214,56,-539,723,21.4,1554.7,15,2,1,7,4,6,1,1,0,0,16086,7.0,17418,207,43,539,-723,20.7,1608.6
4471999593,15,4,0,6,3,3,0,0,0,0,15365,6.4,16848,186,44,-136,-385,18.6,1536.5,19,3,1,3,6,3,0,0,0,0,15501,6.6,17233,219,48,136,385,21.9,1550.1
4521508038,17,1,1,5,4,4,0,0,0,0,16450,7.0,18801,229,72,1771,1846,22.9,1645.0,18,0,0,4,5,4,1,1,0,0,14679,6.6,16955,194,46,-1771,-1846,19.4,1467.9
4512811324,23,3,0,10,5,16,0,0,0,0,17272,6.4,15840,192,40,2171,-261,19.2,1727.2,37,2,1,5,10,6,2,1,1,0,15101,6.6,16101,199,40,-2171,261,19.9,1510.1
4525301191,12,2,0,6,8,6,0,0,0,0,16047,6.8,18460,250,32,-518,-268,25.0,1604.7,16,3,1,8,6,3,2,1,1,0,16565,7.2,18728,211,47,518,268,21.1,1656.5
4484850888,23,3,1,7,1,7,1,1,0,0,16850,7.2,19499,228,64,1994,1541,22.8,1685.0,44,1,0,1,7,2,1,0,1,0,14856,7.0,17958,224,58,-1994,-1541,22.4,1485.6
4502665532,14,2,1,9,11,12,0,0,0,0,17140,6.6,16531,167,30,-791,-961,16.7,1714.0,16,2,0,11,9,11,0,0,0,0,17931,7.0,17492,214,40,791,961,21.4,1793.1
4476255781,14,3,1,15,7,16,0,0,0,0,20036,7.2,19646,178,80,4060,3619,17.8,2003.6,17,3,0,7,15,8,0,0,0,0,15976,6.4,16027,192,44,-4060,-3619,19.2,1597.6
4504146901,14,2,0,2,5,3,0,0,0,0,15128,7.0,17938,251,53,-860,-334,25.1,1512.8,17,2,1,5,2,9,1,1,0,0,15988,7.0,18272,226,52,860,334,22.6,1598.8
4526992864,16,1,1,6,4,11,0,0,0,0,16324,6.8,17601,197,47,541,875,19.7,1632.4,11,6,0,4,6,3,0,0,0,0,15783,6.8,16726,240,44,-541,-875,24.0,1578.3
4515415337,47,3,0,6,5,5,0,0,0,0,16789,7.0,18276,233,48,904,164,23.3,1678.9,18,2,1,5,6,4,1,1,0,0,15885,6.8,18112,234,56,-904,-164,23.4,1588.5
4496533687,14,4,0,4,8,3,1,1,0,0,15049,7.0,17666,218,52,-2088,-870,21.8,1504.9,16,3,1,8,4,7,0,0,0,0,17137,7.2,18536,240,47,2088,870,24.0,1713.7
4515302737,16,2,0,4,13,4,0,0,0,0,14958,6.8,16993,207,47,-4629,-3393,20.7,1495.8,55,4,1,13,4,16,1,1,0,0,19587,7.4,20386,239,46,4629,3393,23.9,1958.7
4479756200,15,3,1,6,10,4,0,0,0,0,16123,6.6,16738,194,49,-2240,-1945,19.4,1612.3,17,2,0,10,6,13,0,0,0,0,18363,6.8,18683,223,52,2240,1945,22.3,1836.3
4509657547,17,6,1,12,11,12,0,0,0,0,19237,7.2,18874,209,72,981,369,20.9,1923.7,14,3,0,11,12,11,0,0,0,0,18256,7.0,18505,233,32,-981,-369,23.3,1825.6
4519044146,12,2,1,3,9,2,0,0,0,0,13808,6.2,15418,169,42,-4523,-3729,16.9,1380.8,18,1,0,9,3,9,1,1,0,0,18331,7.2,19147,219,65,4523,3729,21.9,1833.1
4447620478,16,2,1,7,9,8,1,1,0,0,16876,7.0,17943,223,38,31,-472,22.3,1687.6,37,4,0,9,7,12,0,0,0,0,16845,7.2,18415,207,27,-31,472,20.7,1684.5
4513046591,16,1,1,8,12,7,0,0,0,0,16247,6.6,16555,189,36,-3023,-3630,18.9,1624.7,14,4,0,12,8,9,0,0,0,0,19270,7.6,20185,244,52,3023,3630,24.4,1927.0
4467610572,15,4,1,5,4,6,1,0,1,0,16457,7.0,18669,229,60,1023,1754,22.9,1645.7,19,2,0,4,5,7,0,0,0,0,15434,6.6,16915,219,53,-1023,-1754,21.9,1543.4
4487090574,16,2,1,9,4,11,0,0,0,0,17312,7.0,19125,217,44,2344,1517,21.7,1731.2,39,4,0,4,9,4,0,0,0,0,14968,6.8,17608,201,59,-2344,-1517,20.1,1496.8
4494125131,13,1,1,1,4,0,1,1,0,0,14894,6.6,16548,244,44,-2094,-2508,24.4,1489.4,12,1,0,4,1,7,0,0,0,0,16988,7.0,19056,230,66,2094,2508,23.0,1698.8
4497178201,47,1,1,5,5,8,0,0,0,0,15937,7.0,17560,212,45,-1321,-1186,21.2,1593.7,12,1,0,5,5,5,1,1,0,0,17258,7.2,18746,241,64,1321,1186,24.1,1725.8
4484556262,11,0,1,9,7,13,0,0,0,0,17252,6.4,15960,188,39,166,-1644,18.8,1725.2,16,3,0,7,9,8,1,1,0,0,17086,7.0,17604,192,54,-166,1644,19.2,1708.6
4477855283,18,2,1,15,7,17,1,1,0,1,20932,7.2,19304,233,48,4217,1384,23.3,2093.2,32,4,0,7,15,8,0,0,0,0,16715,7.0,17920,188,64,-4217,-1384,18.8,1671.5
4524906792,49,2,0,6,5,2,0,0,0,0,15739,7.2,18231,193,54,154,159,19.3,1573.9,13,1,1,5,6,5,1,1,0,0,15585,7.0,18072,211,50,-154,-159,21.1,1558.5
4500913253,34,2,1,10,10,12,0,0,0,0,18152,7.0,18364,196,56,-973,-2396,19.6,1815.2,15,2,0,10,10,10,0,0,0,0,19125,7.4,20760,238,68,973,2396,23.8,1912.5
4524024822,13,8,1,12,2,10,2,1,1,1,20860,7.4,21006,268,65,8027,7621,26.8,2086.0,17,2,0,2,12,3,0,0,0,0,12833,5.8,13385,165,36,-8027,-7621,16.5,1283.3
4527291717,71,4,0,4,7,2,0,0,0,0,14961,6.8,17673,215,40,-2090,-916,21.5,1496.1,18,3,1,7,4,7,1,1,0,0,17051,7.0,18589,239,56,2090,916,23.9,1705.1
4520878997,38,4,0,0,4,0,0,0,0,0,14144,6.6,16975,228,60,-1473,-29,22.8,1414.4,18,3,1,4,0,6,1,1,0,0,15617,6.6,17004,228,49,1473,29,22.8,1561.7
4463456988,16,2,0,7,3,4,2,1,1,0,17071,7.2,19347,234,64,1738,2447,23.4,1707.1,16,3,1,3,7,2,0,0,0,0,15333,6.8,16900,226,57,-1738,-2447,22.6,1533.3
4506382089,13,6,1,15,4,12,1,0,1,0,19987,7.2,19679,194,44,4805,3808,19.4,1998.7,16,1,0,4,15,4,1,1,0,0,15182,6.4,15871,194,45,-4805,-3808,19.4,1518.2
4485619170,12,6,1,4,5,6,1,0,1,0,16260,6.8,18128,225,63,266,-282,22.5,1626.0,78,2,0,5,4,10,1,1,0,0,15994,7.2,18410,224,48,-266,282,22.4,1599.4
4522209406,14,3,0,5,10,6,1,1,0,0,14604,6.2,15280,146,52,-4752,-2451,14.6,1460.4,39,2,1,10,5,11,0,0,0,1,19356,6.8,17731,210,47,4752,2451,21.0,1935.6
4521254867,12,2,1,4,8,4,2,1,1,0,14998,6.6,16127,185,45,-1430,147,18.5,1499.8,14,1,0,8,4,7,0,0,0,0,16428,6.6,15980,196,48,1430,-147,19.6,1642.8
4426693677,20,4,1,15,6,12,0,0,0,0,18863,7.2,18943,195,52,2789,585,19.5,1886.3,38,4,0,6,15,4,0,0,0,0,16074,7.0,18358,192,52,-2789,-585,19.2,1607.4
4473438026,17,4,1,8,4,11,1,1,0,0,17117,7.0,18326,204,52,1810,1012,20.4,1711.7,19,4,0,4,8,6,0,0,0,0,15307,6.6,17314,211,44,-1810,-1012,21.1,1530.7
4526758448,124,0,0,1,3,1,1,1,0,0,14997,7.2,17630,229,62,-465,-801,22.9,1499.7,14,2,1,3,1,3,0,0,0,0,15462,7.0,18431,219,58,465,801,21.9,1546.2
4510687386,13,3,0,3,7,2,0,0,0,0,15226,6.8,17102,210,64,-1207,-218,21.0,1522.6,22,1,1,7,3,7,0,0,0,0,16433,6.6,17320,215,44,1207,218,21.5,1643.3
4519801984,18,1,1,7,7,6,1,1,0,0,15927,6.6,15756,192,44,-2390,-2971,19.2,1592.7,13,2,0,7,7,13,0,0,0,0,18317,7.2,18727,219,70,2390,2971,21.9,1831.7
4508846278,28,2,0,12,14,14,1,0,1,0,18331,7.0,18445,181,52,-1572,-208,18.1,1833.1,14,3,1,14,12,17,1,1,0,0,19903,7.0,18653,228,40,1572,208,22.8,1990.3
4519628071,13,1,0,1,7,1,1,0,1,0,13741,6.4,15605,179,56,-2955,-2776,17.9,1374.1,16,2,1,7,1,7,1,1,0,0,16696,7.0,18381,220,47,2955,2776,22.0,1669.6
4523121981,14,6,0,0,6,0,1,0,1,0,14238,6.8,16667,234,48,-2554,-2576,23.4,1423.8,15,1,1,6,0,11,0,0,0,0,16792,7.0,19243,225,52,2554,2576,22.5,1679.2
4499740164,14,2,0,8,10,4,0,0,0,0,15229,6.4,16071,213,4,-4493,-3830,21.3,1522.9,13,2,1,10,8,10,2,1,1,1,19722,7.4,19901,218,68,4493,3830,21.8,1972.2
4493885121,16,2,0,7,2,7,0,0,0,0,16867,7.2,18880,226,47,2333,1998,22.6,1686.7,14,1,1,2,7,3,1,1,0,0,14534,6.6,16882,224,56,-2333,-1998,22.4,1453.4
4513403175,21,2,1,10,1,14,2,1,1,0,19263,7.2,19673,236,59,4739,2119,23.6,1926.3,15,5,0,1,10,0,0,0,0,0,14524,6.8,17554,231,60,-4739,-2119,23.1,1452.4
4506803451,16,4,1,11,2,8,1,1,0,0,19038,7.4,20256,252,46,4090,2523,25.2,1903.8,14,3,0,2,11,3,0,0,0,0,14948,7.0,17733,214,68,-4090,-2523,21.4,1494.8
4468356736,14,2,1,10,10,17,1,1,0,0,18847,7.2,19480,213,76,987,642,21.3,1884.7,14,1,0,10,10,8,0,0,0,0,17860,7.2,18838,206,56,-987,-642,20.6,1786.0
4526108162,18,6,0,6,4,7,0,0,0,0,16827,7.0,18478,252,44,2091,2537,25.2,1682.7,19,3,1,4,6,5,1,1,0,0,14736,6.4,15941,201,37,-2091,-2537,20.1,1473.6
4515399183,17,0,1,6,9,5,2,1,1,0,16149,6.8,16641,199,52,34,-957,19.9,1614.9,34,3,0,9,6,9,0,0,0,0,16115,6.8,17598,184,28,-34,957,18.4,1611.5
4525299931,19,5,1,6,7,8,1,0,1,0,16604,7.0,18077,235,40,-754,-157,23.5,1660.4,26,2,0,7,6,9,0,0,0,0,17358,6.8,18234,243,39,754,157,24.3,1735.8
4521539321,106,1,1,5,9,8,0,0,0,0,15651,6.6,16491,211,55,-1554,-781,21.1,1565.1,12,2,0,9,5,10,0,0,0,0,17205,6.8,17272,203,36,1554,781,20.3,1720.5
4514249734,12,2,0,3,2,3,0,0,0,0,15484,6.8,18175,250,49,239,-709,25.0,1548.4,12,2,1,2,3,0,2,1,1,0,15245,7.2,18884,209,88,-239,709,20.9,1524.5
4510784617,13,19,1,5,8,2,0,0,0,0,16003,7.0,18252,221,50,5,185,22.1,1600.3,45,2,0,8,5,7,1,1,0,0,15998,6.8,18067,189,45,-5,-185,18.9,1599.8
4496613517,17,4,1,9,10,5,0,0,0,0,17193,7.0,18326,224,40,-1027,-1434,22.4,1719.3,16,2,0,10,9,6,0,0,0,0,18220,7.6,19760,236,56,1027,1434,23.6,1822.0
4526390951,12,1,0,2,9,2,0,0,0,0,14606,6.8,17633,200,71,-3513,-1630,20.0,1460.6,14,0,1,9,2,6,1,1,0,0,18119,7.4,19263,221,60,3513,1630,22.1,1811.9
4458702644,14,1,1,4,5,3,0,0,0,0,14682,6.6,17105,199,50,-1827,-2059,19.9,1468.2,17,1,0,5,4,5,0,0,0,0,16509,7.4,19164,235,48,1827,2059,23.5,1650.9
4512338231,13,4,1,7,5,5,1,1,0,0,16790,7.6,19460,241,62,651,1744,24.1,1679.0,13,3,0,5,7,10,0,0,0,0,16139,6.8,17716,186,65,-651,-1744,18.6,1613.9
4449308789,15,1,0,4,9,2,1,1,0,0,15230,6.6,17421,192,68,-2169,-1630,19.2,1523.0,16,1,1,9,4,7,0,0,0,0,17399,7.2,19051,218,26,2169,1630,21.8,1739.9
4513796211,14,0,0,8,12,5,0,0,0,0,16024,7.0,17294,212,46,-2370,-2104,21.2,1602.4,18,3,1,12,8,10,1,1,0,0,18394,7.4,19398,194,61,2370,2104,19.4,1839.4
4511303658,14,4,0,7,4,7,1,1,0,0,16743,7.2,18562,215,45,1323,457,21.5,1674.3,13,0,1,4,7,8,0,0,0,0,15420,7.0,18105,209,52,-1323,-457,20.9,1542.0
4457510743,56,4,0,3,7,3,0,0,0,0,14866,6.6,16219,208,43,-2140,-1892,20.8,1486.6,15,2,1,7,3,9,2,1,1,0,17006,6.8,18111,224,51,2140,1892,22.4,1700.6
4517946996,23,2,0,1,9,2,0,0,0,0,12941,6.4,15085,178,43,-5519,-5521,17.8,1294.1,16,6,1,9,1,10,2,1,1,0,18460,7.6,20606,253,52,5519,5521,25.3,1846.0
4505728122,18,0,0,6,9,7,1,1,0,0,15596,6.2,15360,197,26,-2600,-2112,19.7,1559.6,18,1,1,9,6,7,1,0,1,1,18196,6.6,17472,185,52,2600,2112,18.5,1819.6
4478422383,17,0,1,8,7,8,1,1,0,0,17200,6.6,17501,226,36,528,-805,22.6,1720.0,13,1,0,7,8,7,0,0,0,0,16672,7.2,18306,199,69,-528,805,19.9,1667.2
4526872931,14,4,1,3,4,5,0,0,0,0,15776,7.0,17726,261,52,969,1563,26.1,1577.6,26,1,0,4,3,5,1,1,0,0,14807,6.8,16163,207,44,-969,-1563,20.7,1480.7
4513177731,17,2,1,11,3,8,1,1,0,0,18826,7.4,20300,225,48,3988,4246,22.5,1882.6,18,1,0,3,11,3,1,0,1,0,14838,6.4,16054,195,55,-3988,-4246,19.5,1483.8
4525008225,16,14,0,6,4,7,1,0,1,0,17658,7.2,19584,241,58,1947,2521,24.1,1765.8,35,3,1,4,6,6,0,0,0,0,15711,6.8,17063,247,42,-1947,-2521,24.7,1571.1
4487456805,17,2,0,3,9,4,0,0,0,0,14017,6.6,16680,185,54,-5089,-1828,18.5,1401.7,13,3,1,9,3,10,0,0,0,0,19106,7.0,18508,245,52,5089,1828,24.5,1910.6
4519025105,14,4,0,9,8,11,1,0,1,0,17472,7.2,17708,180,50,-423,-1210,18.0,1747.2,15,4,1,8,9,11,1,1,0,0,17895,7.2,18918,221,54,423,1210,22.1,1789.5
4527258307,17,4,1,6,0,9,0,0,0,0,17774,6.8,18689,226,65,4232,1501,22.6,1777.4,43,4,0,0,6,0,0,0,0,0,13542,7.0,17188,218,62,-4232,-1501,21.8,1354.2
4506847154,11,0,1,6,7,8,1,1,0,0,15684,6.6,17219,202,39,-3240,-2396,20.2,1568.4,16,1,0,7,6,8,1,0,1,1,18924,7.0,19615,257,60,3240,2396,25.7,1892.4
4477975030,19,3,1,5,4,5,0,0,0,0,16157,6.8,17603,240,28,804,365,24.0,1615.7,14,2,0,4,5,4,0,0,0,0,15353,7.0,17238,206,52,-804,-365,20.6,1535.3
4500852521,35,2,1,6,5,6,0,0,0,0,16575,7.0,18673,233,50,-134,-146,23.3,1657.5,16,3,0,5,6,6,1,1,0,0,16709,7.2,18819,242,68,134,146,24.2,1670.9
4462808439,13,1,0,11,11,11,0,0,0,0,18496,7.0,17777,213,50,672,-1567,21.3,1849.6,9,3,1,11,11,6,1,1,0,0,17824,7.2,19344,216,54,-672,1567,21.6,1782.4
4503465904,18,4,1,10,2,8,2,1,1,0,18826,7.2,19835,259,52,5616,3916,25.9,1882.6,15,4,0,2,10,2,0,0,0,0,13210,6.6,15919,184,36,-5616,-3916,18.4,1321.0
4508812859,19,3,1,4,2,6,2,1,1,1,17230,6.6,17823,244,56,1449,-530,24.4,1723.0,39,3,0,2,4,5,0,0,0,0,15781,7.0,18353,229,77,-1449,530,22.9,1578.1
4490758389,22,1,0,6,8,8,0,0,0,1,18198,7.0,17647,220,52,1549,-554,22.0,1819.8,19,4,1,8,6,8,0,0,0,0,16649,7.0,18201,220,40,-1549,554,22.0,1664.9
4519211105,123,2,0,1,7,1,0,0,0,0,14415,6.8,17028,238,47,-2534,-3031,23.8,1441.5,23,3,1,7,1,7,0,0,0,0,16949,7.4,20059,233,60,2534,3031,23.3,1694.9
4512891978,13,1,1,6,4,8,1,1,0,0,15452,7.0,18378,191,49,-1039,827,19.1,1545.2,12,6,0,4,6,4,1,0,1,1,16491,6.8,17551,215,51,1039,-827,21.5,1649.1
4525772082,19,6,0,2,8,2,1,0,1,0,14970,6.8,17809,235,59,-2366,-340,23.5,1497.0,21,4,1,8,2,14,0,0,0,0,17336,6.8,18149,226,34,2366,340,22.6,1733.6
4479922611,14,1,0,7,3,13,0,0,0,0,17800,7.0,19085,223,52,2460,1934,22.3,1780.0,13,1,1,3,7,5,1,1,0,0,15340,6.6,17151,205,60,-2460,-1934,20.5,1534.0
4522586300,18,8,0,0,7,0,0,0,0,0,13358,6.2,15566,199,59,-4737,-3600,19.9,1335.8,17,6,1,7,0,7,1,1,0,0,18095,7.2,19166,253,58,4737,3600,25.3,1809.5
4501989781,11,1,1,6,4,6,0,0,0,0,16368,7.2,18776,204,52,1418,1328,20.4,1636.8,12,1,0,4,6,4,1,1,0,0,14950,6.8,17448,194,55,-1418,-1328,19.4,1495.0
4499681914,15,1,1,1,13,1,0,0,0,0,12622,5.8,13759,185,32,-6954,-5631,18.5,1262.2,17,4,0,13,1,16,2,1,1,0,19576,7.4,19390,228,44,6954,5631,22.8,1957.6
4512587987,15,2,1,3,9,3,0,0,0,0,14719,6.6,16608,195,52,-3485,-2423,19.5,1471.9,37,3,0,9,3,12,1,1,0,0,18204,7.2,19031,237,50,3485,2423,23.7,1820.4
4484417350,15,1,0,2,8,3,0,0,0,0,14433,6.6,16813,202,64,-3215,-1656,20.2,1443.3,21,3,1,8,2,7,1,0,1,0,17648,7.2,18469,243,43,3215,1656,24.3,1764.8
4465328511,18,4,0,4,3,4,1,1,0,0,15181,7.0,17084,216,49,911,449,21.6,1518.1,17,2,1,3,4,4,0,0,0,0,14270,6.8,16635,223,42,-911,-449,22.3,1427.0
4492423421,11,0,1,6,8,5,0,0,0,0,16370,6.8,17433,209,39,-633,-1089,20.9,1637.0,14,1,0,8,6,12,1,1,0,0,17003,7.2,18522,195,66,633,1089,19.5,1700.3
4486229170,16,2,1,5,9,3,0,0,0,0,14953,6.6,17141,183,60,-3042,-3641,18.3,1495.3,18,0,0,9,5,5,1,1,0,0,17995,7.6,20782,224,75,3042,3641,22.4,1799.5
4488005635,15,1,0,2,5,2,1,1,0,0,15281,6.8,17495,248,52,-1201,-919,24.8,1528.1,21,3,1,5,2,11,0,0,0,0,16482,6.8,18414,247,42,1201,919,24.7,1648.2
4525018915,20,5,1,4,6,4,0,0,0,0,15688,6.6,16920,226,53,-162,-553,22.6,1568.8,20,7,0,6,4,10,0,0,0,0,15850,7.0,17473,233,44,162,553,23.3,1585.0
4511419534,15,4,1,7,7,9,0,0,0,0,16276,6.6,17546,215,40,273,-1195,21.5,1627.6,16,3,0,7,7,2,1,0,1,0,16003,7.2,18741,196,48,-273,1195,19.6,1600.3
4510877210,13,4,0,5,6,6,0,0,0,0,15771,6.8,16977,237,38,-1091,-1990,23.7,1577.1,17,5,1,6,5,5,0,0,0,0,16862,7.2,18967,226,46,1091,1990,22.6,1686.2
4499715260,5,0,0,2,15,2,0,0,0,0,13462,5.4,12212,130,42,-9152,-8290,13.0,1346.2,17,1,1,15,2,12,0,0,0,1,22614,7.4,20502,247,80,9152,8290,24.7,2261.4
4501238105,16,1,1,5,7,4,0,0,0,0,16324,7.0,18159,231,60,-330,55,23.1,1632.4,16,3,0,7,5,7,1,1,0,0,16654,7.0,18104,213,60,330,-55,21.3,1665.4
4520495410,14,7,0,6,6,9,1,1,0,1,18409,6.8,18255,212,60,225,-216,21.2,1840.9,24,3,1,6,6,4,1,0,1,2,18184,7.0,18471,242,60,-225,216,24.2,1818.4
4526466522,16,3,0,4,8,3,0,0,0,0,14756,6.8,17655,184,56,-4105,-2279,18.4,1475.6,16,2,1,8,4,8,1,1,0,0,18861,7.4,19934,229,63,4105,2279,22.9,1886.1
4509889673,13,4,1,9,4,12,0,0,0,0,18105,7.0,18937,254,51,2627,1326,25.4,1810.5,38,3,0,4,9,2,0,0,0,0,15478,6.8,17611,216,56,-2627,-1326,21.6,1547.8
4509558169,18,3,0,7,7,4,0,0,0,0,16581,7.0,18360,198,54,462,1726,19.8,1658.1,12,2,1,7,7,8,0,0,0,0,16119,6.6,16634,200,47,-462,-1726,20.0,1611.9
4505242259,63,2,0,4,2,4,0,0,0,0,15514,7.2,18840,235,64,-81,882,23.5,1551.4,13,0,1,2,4,1,0,0,0,0,15595,7.0,17958,261,55,81,-882,26.1,1559.5
4525584889,15,2,1,4,6,2,0,0,0,0,15729,7.0,18102,205,60,-448,-163,20.5,1572.9,15,4,0,6,4,6,1,1,0,0,16177,7.0,18265,232,43,448,163,23.2,1617.7
4518283013,16,7,1,8,8,9,1,1,0,0,17055,7.0,17918,199,48,-431,120,19.9,1705.5,20,2,0,8,8,13,0,0,0,0,17486,7.0,17798,221,52,431,-120,22.1,1748.6
4518300534,15,0,0,6,6,9,0,0,0,0,16299,6.8,17800,226,42,80,-599,22.6,1629.9,13,2,1,6,6,4,1,1,0,0,16219,7.2,18399,210,48,-80,599,21.0,1621.9
4519480977,42,5,0,6,6,10,0,0,0,0,16206,6.8,17669,221,49,-677,-67,22.1,1620.6,18,8,1,6,6,10,1,1,0,0,16883,6.8,17736,245,45,677,67,24.5,1688.3
4515946724,16,1,0,6,4,6,0,0,0,0,17025,7.0,18219,211,59,1196,-85,21.1,1702.5,16,2,1,4,6,2,1,1,0,0,15829,7.0,18304,228,64,-1196,85,22.8,1582.9
4450343886,16,1,1,8,7,9,0,0,0,0,17169,7.0,17752,210,51,734,-965,21.0,1716.9,61,2,0,7,8,5,0,0,0,0,16435,7.0,18717,207,58,-734,965,20.7,1643.5
4507115446,14,8,0,6,4,11,1,1,0,0,16538,7.2,18707,235,55,1585,1348,23.5,1653.8,14,3,1,4,6,4,0,0,0,0,14953,6.6,17359,189,44,-1585,-1348,18.9,1495.3
4518834172,20,3,1,4,4,2,0,0,0,0,14926,7.0,19450,203,59,-842,2032,20.3,1492.6,15,4,0,4,4,7,1,0,1,0,15768,7.0,17418,243,47,842,-2032,24.3,1576.8
4514156871,12,2,1,4,4,2,2,1,1,0,15534,7.0,18339,223,64,-483,-442,22.3,1553.4,14,2,0,4,4,5,0,0,0,0,16017,7.2,18781,266,52,483,442,26.6,1601.7
4499984272,21,3,0,4,8,7,0,0,0,0,14655,6.6,16541,208,37,-3142,-2633,20.8,1465.5,20,3,1,8,4,17,1,0,1,0,17797,7.2,19174,216,56,3142,2633,21.6,1779.7
4500649869,13,3,1,3,2,3,1,1,0,0,15298,7.0,17946,232,60,383,-759,23.2,1529.8,16,1,0,2,3,0,0,0,0,0,14915,7.2,18705,233,72,-383,759,23.3,1491.5
4474570659,13,3,1,11,6,10,0,0,0,0,18335,6.8,17921,238,36,2498,732,23.8,1833.5,15,1,0,6,11,7,0,0,0,0,15837,6.8,17189,194,52,-2498,-732,19.4,1583.7
4510115879,18,2,0,4,12,6,0,0,0,0,15207,6.6,16955,213,44,-5324,-2914,21.3,1520.7,16,1,1,12,4,12,2,1,1,1,20531,7.2,19869,205,64,5324,2914,20.5,2053.1
4476153650,52,7,0,6,5,11,1,1,0,0,15975,6.6,16937,197,46,-166,-337,19.7,1597.5,19,4,1,5,6,4,0,0,0,0,16141,6.8,17274,231,39,166,337,23.1,1614.1
4525318009,14,0,0,4,3,5,0,0,0,0,15568,6.8,17520,246,36,40,-731,24.6,1556.8,35,2,1,3,4,6,0,0,0,0,15528,6.8,18251,211,56,-40,731,21.1,1552.8
4508183655,12,6,0,6,1,10,0,0,0,0,16702,7.2,18943,234,56,1868,1041,23.4,1670.2,20,2,1,1,6,1,1,1,0,0,14834,7.0,17902,230,60,-1868,-1041,23.0,1483.4
4463024546,63,4,0,2,4,2,0,0,0,0,15264,7.0,17806,217,64,-286,606,21.7,1526.4,16,1,1,4,2,6,2,1,1,0,15550,6.8,17200,235,47,286,-606,23.5,1555.0
4525911373,26,1,1,15,3,24,2,1,1,2,23701,7.8,21188,239,70,8863,5411,23.9,2370.1,12,1,0,3,15,2,0,0,0,0,14838,6.4,15777,197,44,-8863,-5411,19.7,1483.8
4474736524,17,2,0,3,9,2,0,0,0,0,14660,6.6,17265,203,45,-3251,-2143,20.3,1466.0,13,4,1,9,3,5,1,1,0,0,17911,7.2,19408,234,52,3251,2143,23.4,1791.1
4520687203,21,3,1,11,6,8,0,0,0,1,19022,7.0,19112,217,48,3028,2524,21.7,1902.2,18,3,0,6,11,8,0,0,0,0,15994,6.4,16588,190,51,-3028,-2524,19.0,1599.4
4460355612,33,1,0,10,7,11,1,0,1,1,19186,7.2,18375,183,51,1377,795,18.3,1918.6,14,2,1,7,10,8,1,1,0,0,17809,7.0,17580,201,52,-1377,-795,20.1,1780.9
4518963462,22,4,0,6,12,7,0,0,0,0,16851,6.8,17931,201,48,-2286,-976,20.1,1685.1,68,3,1,12,6,15,0,0,0,0,19137,7.0,18907,199,52,2286,976,19.9,1913.7
4518019650,11,4,1,3,5,3,0,0,0,0,15029,7.0,17571,230,40,-1420,-1415,23.0,1502.9,103,1,0,5,3,5,1,1,0,0,16449,7.0,18986,222,56,1420,1415,22.2,1644.9
4513537604,17,3,0,10,12,10,0,0,0,0,17517,7.4,19291,179,56,-1567,505,17.9,1751.7,15,3,1,12,10,13,0,0,0,0,19084,7.0,18786,219,32,1567,-505,21.9,1908.4
4477599823,44,4,1,9,5,16,0,0,0,0,17433,6.8,17284,198,32,1668,-774,19.8,1743.3,19,3,0,5,9,4,2,1,1,0,15765,7.0,18058,210,72,-1668,774,21.0,1576.5
4523353558,14,3,0,1,7,0,0,0,0,0,13633,6.4,16221,202,53,-5800,-3960,20.2,1363.3,12,1,1,7,1,15,1,1,0,1,19433,7.6,20181,245,74,5800,3960,24.5,1943.3
4483760431,11,1,0,8,5,10,2,1,1,0,17823,7.4,19752,215,64,1014,950,21.5,1782.3,9,1,1,5,8,5,0,0,0,0,16809,7.0,18802,219,75,-1014,-950,21.9,1680.9
4490264226,18,2,1,10,4,11,0,0,0,0,18851,7.4,19227,252,52,3737,1796,25.2,1885.1,14,3,0,4,10,4,0,0,0,0,15114,7.0,17431,203,45,-3737,-1796,20.3,1511.4
4525152845,14,1,0,4,12,3,0,0,0,0,14456,6.6,17039,212,46,-4680,-3190,21.2,1445.6,15,1,1,12,4,14,2,1,1,0,19136,7.6,20229,220,64,4680,3190,22.0,1913.6
4477390538,15,2,1,8,3,8,1,1,0,0,17623,7.0,17787,229,48,3100,1006,22.9,1762.3,26,2,0,3,8,2,0,0,0,0,14523,6.8,16781,209,47,-3100,-1006,20.9,1452.3
4523569413,15,2,1,8,6,8,1,1,0,0,18198,7.0,18250,246,40,2713,464,24.6,1819.8,14,0,0,6,8,3,1,0,1,0,15485,6.8,17786,187,56,-2713,-464,18.7,1548.5
4470196498,14,1,0,8,11,8,0,0,0,0,16483,6.8,16652,186,50,-1412,-405,18.6,1648.3,14,3,1,11,8,18,1,1,0,0,17895,6.8,17057,208,38,1412,405,20.8,1789.5
4500708488,12,3,0,3,4,5,0,0,0,0,15537,7.0,18851,231,64,-937,-89,23.1,1553.7,16,5,1,4,3,5,1,1,0,0,16474,7.2,18940,251,68,937,89,25.1,1647.4
4491767708,14,7,0,3,8,3,0,0,0,0,15160,7.0,17505,217,52,-2174,-1268,21.7,1516.0,13,3,1,8,3,12,2,1,1,0,17334,7.2,18773,227,64,2174,1268,22.7,1733.4
4502257750,17,2,1,6,9,5,0,0,0,0,15900,6.6,16277,208,40,-3237,-2680,20.8,1590.0,38,4,0,9,6,6,1,0,1,1,19137,7.0,18957,219,52,3237,2680,21.9,1913.7
4518060637,14,2,0,9,5,13,0,0,0,0,17099,7.2,19592,225,48,1344,2079,22.5,1709.9,16,1,1,5,9,2,1,1,0,0,15755,6.8,17513,238,48,-1344,-2079,23.8,1575.5
4511912141,12,3,1,8,4,9,1,1,0,0,17779,6.8,18276,247,53,2988,398,24.7,1777.9,14,1,0,4,8,1,0,0,0,0,14791,7.0,17878,210,47,-2988,-398,21.0,1479.1
4503433606,10,2,0,4,11,2,0,0,0,0,15602,6.6,17116,216,38,-2082,-527,21.6,1560.2,45,2,1,11,4,13,1,1,0,0,17684,6.8,17643,199,44,2082,527,19.9,1768.4
4510352485,14,2,1,6,0,7,0,0,0,0,17476,7.2,19471,226,68,3460,2275,22.6,1747.6,17,2,0,0,6,0,1,1,0,0,14016,6.8,17196,242,64,-3460,-2275,24.2,1401.6
4510011476,16,2,1,7,3,9,0,0,0,0,17188,7.2,19483,244,57,2010,1365,24.4,1718.8,10,2,0,3,7,0,0,0,0,0,15178,6.8,18118,226,71,-2010,-1365,22.6,1517.8
4441748703,26,1,1,10,6,9,1,1,0,0,17252,7.0,18227,212,40,1154,999,21.2,1725.2,15,1,0,6,10,5,0,0,0,0,16098,7.0,17228,220,42,-1154,-999,22.0,1609.8
4472940975,17,5,1,5,1,6,1,1,0,0,15258,7.0,18398,223,44,993,872,22.3,1525.8,69,2,0,1,5,1,0,0,0,0,14265,6.8,17526,225,59,-993,-872,22.5,1426.5
4467563573,18,3,0,8,6,15,1,1,0,0,16501,6.2,15376,190,27,-383,-667,19.0,1650.1,18,3,1,6,8,9,0,0,0,0,16884,6.6,16043,229,50,383,667,22.9,1688.4
4465219172,57,1,0,4,5,3,1,1,0,0,15288,7.0,18195,242,56,-1538,-320,24.2,1528.8,18,4,1,5,4,9,0,0,0,0,16826,7.0,18515,226,60,1538,320,22.6,1682.6
4512135752,13,4,0,4,2,3,0,0,0,0,15750,7.0,18310,233,52,755,-289,23.3,1575.0,16,2,1,2,4,2,1,1,0,0,14995,7.0,18599,248,57,-755,289,24.8,1499.5
4507588254,18,2,1,10,0,16,0,0,0,0,18059,7.0,18165,218,44,5224,2715,21.8,1805.9,15,1,0,0,10,0,1,1,0,0,12835,6.4,15450,200,41,-5224,-2715,20.0,1283.5
4481739224,19,5,0,6,6,9,0,0,0,0,16740,7.0,19237,238,54,218,1085,23.8,1674.0,18,4,1,6,6,8,1,1,0,0,16522,7.0,18152,229,54,-218,-1085,22.9,1652.2
4513250819,16,1,1,11,11,6,2,1,1,0,17558,7.0,18661,174,64,-369,-379,17.4,1755.8,34,4,0,11,11,11,0,0,0,0,17927,7.4,19040,188,44,369,379,18.8,1792.7
4500949435,17,5,0,4,6,8,1,0,1,0,15922,7.0,17677,245,59,-1185,-1150,24.5,1592.2,17,4,1,6,4,7,1,1,0,0,17107,7.2,18827,236,48,1185,1150,23.6,1710.7
4459608159,26,5,1,4,1,3,0,0,0,0,16210,6.8,19051,261,41,1169,564,26.1,1621.0,20,5,0,1,4,1,1,1,0,0,15041,7.0,18487,232,69,-1169,-564,23.2,1504.1
4510559226,17,3,0,6,3,9,1,1,0,0,15692,6.8,17598,217,32,189,-99,21.7,1569.2,16,3,1,3,6,2,0,0,0,0,15503,6.6,17697,244,48,-189,99,24.4,1550.3
4508930231,16,3,0,5,6,6,0,0,0,0,15268,6.6,17072,211,49,-2308,-1946,21.1,1526.8,12,2,1,6,5,8,1,1,0,0,17576,7.2,19018,263,56,2308,1946,26.3,1757.6
4520321309,13,1,1,6,4,5,0,0,0,0,16304,6.8,17328,212,36,205,-1306,21.2,1630.4,14,4,0,4,6,5,2,1,1,0,16099,7.0,18634,203,75,-205,1306,20.3,1609.9
4512153524,16,4,1,3,7,4,0,0,0,0,15033,6.6,16265,226,47,-1520,-613,22.6,1503.3,24,2,0,7,3,14,0,0,0,0,16553,6.6,16878,201,53,1520,613,20.1,1655.3
4491235821,17,3,1,13,3,14,1,1,0,1,20961,7.6,19939,225,74,6387,3453,22.5,2096.1,12,5,0,3,13,2,1,0,1,0,14574,6.6,16486,182,57,-6387,-3453,18.2,1457.4
4503591121,17,6,0,7,8,7,1,1,0,0,17459,6.8,17773,209,56,-1,-459,20.9,1745.9,42,5,1,8,7,6,0,0,0,0,17460,6.8,18232,231,52,1,459,23.1,1746.0
4446019299,17,1,1,6,3,7,1,1,0,1,18564,7.0,18738,239,44,4518,1715,23.9,1856.4,11,3,0,3,6,2,0,0,0,0,14046,6.8,17023,169,55,-4518,-1715,16.9,1404.6
4523799496,11,3,0,7,9,5,1,0,1,0,17528,7.2,19609,234,68,-904,1377,23.4,1752.8,18,1,1,9,7,9,1,1,0,0,18432,7.0,18232,227,40,904,-1377,22.7,1843.2
4447641028,79,1,1,11,14,10,0,0,0,0,16978,5.6,13699,158,28,-4259,-3503,15.8,1697.8,28,3,0,14,11,21,1,0,1,2,21237,7.0,17202,203,34,4259,3503,20.3,2123.7
4384417283,19,2,0,10,3,13,1,1,0,0,17951,7.2,18502,226,44,3022,2631,22.6,1795.1,13,4,1,3,10,5,0,0,0,0,14929,6.6,15871,209,44,-3022,-2631,20.9,1492.9
4468676047,13,2,1,6,9,7,2,1,1,0,15928,6.4,16033,173,67,-1885,-1025,17.3,1592.8,12,0,0,9,6,10,0,0,0,0,17813,6.8,17058,233,17,1885,1025,23.3,1781.3
4516825345,13,0,1,7,8,7,0,0,0,0,16561,7.0,17480,201,60,-519,-643,20.1,1656.1,14,2,0,8,7,9,2,1,1,0,17080,7.0,18123,228,52,519,643,22.8,1708.0
4467764577,16,3,0,5,4,4,1,1,0,0,15873,7.2,18580,236,44,-14,-19,23.6,1587.3,21,3,1,4,5,4,0,0,0,0,15887,7.2,18599,232,55,14,19,23.2,1588.7
4509595307,38,4,0,2,5,2,0,0,0,0,13889,6.8,16733,193,57,-1656,-453,19.3,1388.9,13,3,1,5,2,8,1,1,0,0,15545,6.6,17186,229,44,1656,453,22.9,1554.5
4490249135,15,3,1,6,10,5,0,0,0,0,15164,6.4,16581,190,41,-4055,-2248,19.0,1516.4,32,1,0,10,6,10,1,0,1,0,19219,7.2,18829,236,58,4055,2248,23.6,1921.9
4456349492,45,2,1,9,4,6,2,1,1,0,18233,7.6,21650,244,58,3319,5284,24.4,1823.3,12,15,0,4,9,7,0,0,0,0,14914,6.6,16366,177,53,-3319,-5284,17.7,1491.4
4523323682,15,4,1,7,6,8,0,0,0,0,16495,6.8,17444,211,48,222,-72,21.1,1649.5,17,2,0,6,7,6,1,1,0,0,16273,6.8,17516,205,52,-222,72,20.5,1627.3
4452001720,13,4,0,2,13,3,0,0,0,0,12798,5.4,12111,187,4,-8472,-8242,18.7,1279.8,16,1,1,13,2,16,1,1,0,1,21270,7.6,20353,224,64,8472,8242,22.4,2127.0
4520004131,14,4,1,5,5,4,1,1,0,0,15885,6.6,16411,213,54,-508,-1263,21.3,1588.5,35,1,0,5,5,5,0,0,0,0,16393,7.0,17674,235,46,508,1263,23.5,1639.3
4470291861,16,2,0,12,7,19,1,1,0,1,20721,7.0,18605,247,49,4453,1296,24.7,2072.1,15,3,1,7,12,13,0,0,0,0,16268,7.0,17309,206,48,-4453,-1296,20.6,1626.8
4527873286,17,2,1,7,4,5,1,1,0,0,17765,7.2,18967,211,69,2519,2469,21.1,1776.5,46,3,0,4,7,7,0,0,0,0,15246,6.8,16498,229,34,-2519,-2469,22.9,1524.6
4501126526,14,0,1,6,4,12,2,1,1,0,16939,7.0,17733,211,56,1419,731,21.1,1693.9,18,3,0,4,6,6,0,0,0,0,15520,6.6,17002,227,54,-1419,-731,22.7,1552.0
4469852956,17,3,0,5,5,4,0,0,0,0,16545,7.2,19148,235,67,-207,-251,23.5,1654.5,15,4,1,5,5,6,1,1,0,0,16752,7.2,19399,235,72,207,251,23.5,1675.2
4526934596,17,5,1,6,3,6,0,0,0,0,17854,7.6,20729,260,80,3215,3092,26.0,1785.4,16,2,0,3,6,3,0,0,0,0,14639,6.6,17637,194,55,-3215,-3092,19.4,1463.9
4518577931,14,3,0,3,5,5,0,0,0,0,15529,6.6,17787,237,46,-522,-1373,23.7,1552.9,18,2,1,5,3,2,1,1,0,0,16051,7.0,19160,222,60,522,1373,22.2,1605.1
4506187953,13,0,0,6,5,5,0,0,0,0,15687,6.6,18199,206,46,-423,716,20.6,1568.7,16,5,1,5,6,6,0,0,0,0,16110,7.0,17483,219,44,423,-716,21.9,1611.0
4515518860,13,2,1,7,7,4,1,0,1,0,16699,7.0,18064,212,48,559,55,21.2,1669.9,16,3,0,7,7,7,1,1,0,0,16140,7.2,18009,194,56,-559,-55,19.4,1614.0
4506831821,15,2,1,2,12,3,0,0,0,0,14379,6.6,16423,203,49,-6676,-3924,20.3,1437.9,12,5,0,12,2,14,1,1,0,1,21055,7.2,20347,223,66,6676,3924,22.3,2105.5
4525214447,16,2,1,11,3,13,0,0,0,0,19008,7.4,18920,206,52,4255,2387,20.6,1900.8,95,2,0,3,11,1,0,0,0,0,14753,6.6,16533,202,63,-4255,-2387,20.2,1475.3
4527797466,54,0,0,6,4,8,1,1,0,0,16238,7.2,19255,233,48,782,888,23.3,1623.8,12,21,1,4,6,3,0,0,0,0,15456,7.0,18367,206,56,-782,-888,20.6,1545.6
4500122994,16,1,1,3,2,1,1,1,0,0,16238,7.0,18724,241,60,1443,-453,24.1,1623.8,20,2,0,2,3,2,0,0,0,0,14795,7.2,19177,215,68,-1443,453,21.5,1479.5
4521611632,10,1,1,7,6,11,2,1,1,0,17410,7.2,18496,239,62,1590,971,23.9,1741.0,12,0,0,6,7,8,0,0,0,0,15820,7.0,17525,216,46,-1590,-971,21.6,1582.0
4420941972,25,3,1,6,5,7,1,0,1,1,17826,7.4,19427,225,67,1909,979,22.5,1782.6,16,3,0,5,6,3,0,0,0,0,15917,7.0,18448,220,48,-1909,-979,22.0,1591.7
4513397052,13,0,1,7,9,9,0,0,0,0,16538,6.8,17488,204,55,-571,-401,20.4,1653.8,17,1,0,9,7,12,1,1,0,0,17109,6.8,17889,222,40,571,401,22.2,1710.9
4462200900,37,5,1,9,6,13,0,0,0,0,17187,7.0,18709,199,47,619,1021,19.9,1718.7,19,3,0,6,9,6,1,1,0,0,16568,6.8,17688,214,67,-619,-1021,21.4,1656.8
4524921739,16,2,1,6,8,11,0,0,0,0,16270,6.8,17661,200,54,-82,117,20.0,1627.0,15,3,0,8,6,4,1,1,0,0,16352,6.8,17544,221,37,82,-117,22.1,1635.2
4454677034,15,4,0,8,11,9,1,0,1,0,17080,7.2,18330,196,41,-2247,-1938,19.6,1708.0,17,2,1,11,8,6,0,0,0,0,19327,7.4,20268,227,60,2247,1938,22.7,1932.7
4502741131,17,1,1,10,7,13,0,0,0,0,18446,7.2,19075,195,44,1918,1638,19.5,1844.6,11,2,0,7,10,8,2,1,1,0,16528,7.0,17437,191,48,-1918,-1638,19.1,1652.8
4494341320,16,3,1,4,2,8,1,1,0,0,16547,7.2,19666,259,64,1268,1705,25.9,1654.7,31,0,0,2,4,3,0,0,0,0,15279,7.0,17961,249,44,-1268,-1705,24.9,1527.9
4524820601,11,1,1,9,11,11,0,0,0,0,17322,6.4,16229,182,52,-956,-1451,18.2,1732.2,14,1,0,11,9,12,1,1,0,0,18278,6.8,17680,207,49,956,1451,20.7,1827.8
4520773672,19,3,1,13,4,17,0,0,0,0,19145,7.2,19160,218,40,4947,3211,21.8,1914.5,15,4,0,4,13,2,1,1,0,0,14198,6.2,15949,203,36,-4947,-3211,20.3,1419.8
4508408940,35,3,0,3,6,2,1,1,0,0,13879,6.6,16319,148,62,-2967,-3336,14.8,1387.9,14,2,1,6,3,2,0,0,0,0,16846,7.2,19655,223,69,2967,3336,22.3,1684.6
4485493657,16,3,1,6,7,8,0,0,0,0,16554,6.6,17192,215,49,-154,-193,21.5,1655.4,16,2,0,7,6,9,1,0,1,0,16708,6.8,17385,218,48,154,193,21.8,1670.8
4442489042,11,1,1,5,1,5,0,0,0,0,17467,7.4,20584,245,76,3407,3210,24.5,1746.7,85,0,0,1,5,3,0,0,0,0,14060,6.8,17374,214,59,-3407,-3210,21.4,1406.0
4525070748,19,2,1,9,3,8,0,0,0,0,17049,6.8,17241,202,41,1863,328,20.2,1704.9,17,2,0,3,9,5,0,0,0,0,15186,6.8,16913,204,58,-1863,-328,20.4,1518.6
4489550843,16,2,1,6,3,5,1,1,0,0,16931,7.0,18085,225,54,2443,1566,22.5,1693.1,15,2,0,3,6,4,0,0,0,0,14488,6.4,16519,201,61,-2443,-1566,20.1,1448.8
4525245077,24,4,1,10,7,11,2,1,1,0,18256,7.0,18201,186,58,1489,-192,18.6,1825.6,17,3,0,7,10,7,0,0,0,0,16767,7.0,18393,247,28,-1489,192,24.7,1676.7
4513437508,14,3,1,7,1,5,0,0,0,0,16961,7.2,19188,245,43,4060,3257,24.5,1696.1,16,0,0,1,7,1,0,0,0,0,12901,6.4,15931,176,45,-4060,-3257,17.6,1290.1
4524264529,12,4,0,5,8,5,1,1,0,0,16245,7.0,17547,206,52,-1051,753,20.6,1624.5,18,2,1,8,5,11,0,0,0,0,17296,6.8,16794,206,48,1051,-753,20.6,1729.6
4525224702,15,3,1,4,3,2,1,0,1,0,16408,7.2,19181,263,53,2591,1567,26.3,1640.8,15,2,0,3,4,1,1,1,0,0,13817,6.8,17614,208,35,-2591,-1567,20.8,1381.7
4523629089,14,2,0,3,8,5,0,0,0,0,14425,6.6,16191,198,47,-2619,-1506,19.8,1442.5,17,3,1,8,3,9,1,1,0,0,17044,6.6,17697,212,49,2619,1506,21.2,1704.4
4517996305,18,3,0,1,9,1,0,0,0,0,13599,6.4,15596,229,32,-5031,-5211,22.9,1359.9,16,3,1,9,1,6,0,0,0,0,18630,7.6,20807,241,71,5031,5211,24.1,1863.0
4515606448,15,2,0,4,6,7,1,1,0,0,15520,7.0,17369,207,59,-1949,-1983,20.7,1552.0,37,2,1,6,4,10,1,0,1,0,17469,7.2,19352,230,56,1949,1983,23.0,1746.9
4516402388,15,4,1,4,3,2,1,0,1,0,15833,7.2,18396,250,52,904,1043,25.0,1583.3,21,4,0,3,4,3,1,1,0,0,14929,6.8,17353,213,64,-904,-1043,21.3,1492.9
4439155186,16,4,0,7,6,9,0,0,0,0,16869,7.2,18297,230,55,713,-58,23.0,1686.9,19,2,1,6,7,9,1,1,0,0,16156,6.8,18355,213,48,-713,58,21.3,1615.6
4507950009,17,3,0,4,7,4,1,0,1,0,15293,6.8,17145,192,64,-1809,-1431,19.2,1529.3,41,2,1,7,4,11,1,1,0,0,17102,7.0,18576,215,52,1809,1431,21.5,1710.2
4519670667,58,1,1,6,3,6,1,1,0,0,17604,7.4,20758,248,67,2547,2796,24.8,1760.4,36,0,0,3,6,2,0,0,0,0,15057,6.6,17962,195,60,-2547,-2796,19.5,1505.7
4481919426,14,2,0,9,6,13,1,1,0,0,17235,6.8,17249,196,47,1177,-691,19.6,1723.5,16,4,1,6,9,7,0,0,0,0,16058,6.8,17940,232,37,-1177,691,23.2,1605.8
4521258237,54,4,1,7,3,8,0,0,0,0,17552,7.4,19684,233,53,2098,2184,23.3,1755.2,14,2,0,3,7,3,2,1,1,0,15454,6.8,17500,236,46,-2098,-2184,23.6,1545.4
4463059486,16,3,0,4,12,5,1,1,0,0,15380,6.6,15984,226,43,-4864,-2818,22.6,1538.0,17,2,1,12,4,17,1,0,1,2,20244,7.2,18802,231,36,4864,2818,23.1,2024.4
4489533788,16,2,0,5,4,6,0,0,0,0,16721,7.0,18046,237,53,1788,2424,23.7,1672.1,15,2,1,4,5,6,0,0,0,0,14933,6.4,15622,210,42,-1788,-2424,21.0,1493.3
4473252742,14,0,0,7,9,5,0,0,0,0,16474,6.6,17408,209,50,-1559,-407,20.9,1647.4,22,4,1,9,7,13,1,1,0,0,18033,6.8,17815,206,53,1559,407,20.6,1803.3
4514521054,15,4,0,2,9,2,1,1,0,0,14730,6.6,17103,246,41,-4406,-2663,24.6,1473.0,30,1,1,9,2,6,1,0,1,1,19136,7.6,19766,233,60,4406,2663,23.3,1913.6
4516123814,22,0,0,6,10,5,0,0,0,0,16108,6.4,16262,211,42,-1701,-771,21.1,1610.8,16,2,1,10,6,16,0,0,0,0,17809,6.8,17033,190,52,1701,771,19.0,1780.9
4462766288,16,4,0,11,2,7,1,1,0,0,17389,7.2,18459,221,52,2577,2588,22.1,1738.9,18,2,1,2,11,2,1,0,1,0,14812,6.6,15871,218,53,-2577,-2588,21.8,1481.2
4521908299,15,1,1,11,1,8,2,1,1,0,18635,7.2,19958,230,64,4368,3523,23.0,1863.5,14,2,0,1,11,0,0,0,0,0,14267,6.6,16435,208,64,-4368,-3523,20.8,1426.7
4523513281,15,0,0,8,5,12,0,0,0,0,17327,7.0,18655,203,65,1568,611,20.3,1732.7,14,2,1,5,8,5,0,0,0,0,15759,7.0,18044,212,44,-1568,-611,21.2,1575.9
4509176495,18,3,1,8,6,11,0,0,0,0,16870,6.6,16180,212,44,829,-929,21.2,1687.0,19,5,0,6,8,5,1,1,0,0,16041,6.6,17109,245,46,-829,929,24.5,1604.1
4512954515,22,5,0,7,6,14,1,1,0,0,16644,6.8,17295,238,48,60,-325,23.8,1664.4,21,6,1,6,7,11,0,0,0,0,16584,6.8,17620,229,44,-60,325,22.9,1658.4
4520757711,10,3,0,4,7,1,0,0,0,0,15038,6.8,17152,230,52,-1535,-716,23.0,1503.8,16,1,1,7,4,8,1,1,0,0,16573,6.8,17868,215,60,1535,716,21.5,1657.3
4432359708,12,6,0,2,5,1,0,0,0,0,13860,6.6,16835,193,52,-2807,-1537,19.3,1386.0,90,5,1,5,2,6,0,0,0,0,16667,6.8,18372,249,42,2807,1537,24.9,1666.7
4515879923,14,4,1,5,11,7,1,0,1,0,15285,6.6,15530,185,44,-2302,-1871,18.5,1528.5,44,2,0,11,5,14,1,1,0,0,17587,6.8,17401,165,44,2302,1871,16.5,1758.7
4510397182,17,4,1,11,4,8,1,0,1,0,17781,7.2,19581,225,45,2359,1828,22.5,1778.1,79,3,0,4,11,3,0,0,0,0,15422,6.8,17753,215,60,-2359,-1828,21.5,1542.2
4522027915,21,0,1,10,5,7,1,0,1,0,17971,7.2,19214,231,44,3146,1518,23.1,1797.1,12,3,0,5,10,2,1,1,0,0,14825,7.0,17696,181,47,-3146,-1518,18.1,1482.5
4515376019,18,2,1,8,6,5,2,1,1,0,16650,6.8,17551,233,37,907,-411,23.3,1665.0,11,6,0,6,8,3,0,0,0,0,15743,6.6,17962,195,66,-907,411,19.5,1574.3
4502951007,15,2,1,8,2,10,0,0,0,0,17620,6.8,17878,236,41,2978,-438,23.6,1762.0,16,4,0,2,8,4,0,0,0,0,14642,7.2,18316,180,67,-2978,438,18.0,1464.2
4459250324,18,1,1,7,1,13,0,0,0,0,18486,7.4,20095,264,68,5159,4916,26.4,1848.6,16,2,0,1,7,2,1,1,0,0,13327,6.4,15179,182,48,-5159,-4916,18.2,1332.7
4521865491,11,2,1,14,6,15,0,0,0,0,21087,7.6,20108,215,36,5260,2633,21.5,2108.7,39,1,0,6,14,5,1,1,0,0,15827,7.0,17475,193,48,-5260,-2633,19.3,1582.7
4509390548,16,0,1,6,9,9,0,0,0,0,15728,6.6,17183,208,44,-2701,-2275,20.8,1572.8,16,2,0,9,6,8,0,0,0,0,18429,7.2,19458,208,56,2701,2275,20.8,1842.9
4501794843,15,4,1,4,1,4,0,0,0,0,16385,7.0,18374,249,44,3001,1223,24.9,1638.5,60,1,0,1,4,0,1,1,0,0,13384,6.8,17151,213,42,-3001,-1223,21.3,1338.4
4485610478,14,5,1,5,9,8,0,0,0,0,14927,6.6,15638,196,25,-2614,-1880,19.6,1492.7,17,3,0,9,5,16,1,1,0,0,17541,6.8,17518,214,47,2614,1880,21.4,1754.1
4514283603,17,1,1,6,8,4,1,1,0,0,16021,6.8,18021,199,48,-620,-384,19.9,1602.1,14,5,0,8,6,9,0,0,0,0,16641,7.2,18405,217,44,620,384,21.7,1664.1
4523763219,17,3,1,7,2,9,1,0,1,0,17557,7.0,18193,209,64,3822,2980,20.9,1755.7,18,2,0,2,7,1,0,0,0,0,13735,6.0,15213,224,24,-3822,-2980,22.4,1373.5
4513213507,41,2,1,10,11,14,1,1,0,0,19020,6.8,18128,216,52,609,-19,21.6,1902.0,14,7,0,11,10,14,1,0,1,0,18411,6.8,18147,221,31,-609,19,22.1,1841.1
4527461215,11,3,1,8,7,10,0,0,0,0,17122,7.0,17535,204,51,312,-1396,20.4,1712.2,47,2,0,7,8,7,1,1,0,0,16810,7.0,18931,211,51,-312,1396,21.1,1681.0
4465693546,17,1,0,10,9,9,2,1,1,0,17868,7.0,17858,177,56,-286,-916,17.7,1786.8,20,5,1,9,10,11,0,0,0,0,18154,7.0,18774,247,56,286,916,24.7,1815.4
4511924460,17,3,1,9,8,10,0,0,0,0,17875,6.8,17347,212,45,1171,-841,21.2,1787.5,15,3,0,8,9,11,0,0,0,0,16704,7.2,18188,190,49,-1171,841,19.0,1670.4
4478250976,16,4,0,9,8,8,0,0,0,0,16956,6.8,17632,219,39,-540,238,21.9,1695.6,15,1,1,8,9,8,0,0,0,0,17496,6.8,17394,205,44,540,-238,20.5,1749.6
4524256472,23,6,1,7,6,5,1,1,0,0,16898,7.0,17534,226,53,599,267,22.6,1689.8,29,6,0,6,7,7,1,0,1,0,16299,6.8,17267,203,50,-599,-267,20.3,1629.9
4523838951,90,1,1,4,5,2,0,0,0,0,15246,7.0,17687,217,47,-671,-738,21.7,1524.6,18,4,0,5,4,2,1,1,0,0,15917,7.0,18425,227,56,671,738,22.7,1591.7
4527394584,16,1,0,7,7,5,0,0,0,0,16354,6.8,18198,213,41,-1256,-559,21.3,1635.4,17,2,1,7,7,5,2,1,1,0,17610,7.0,18757,226,62,1256,559,22.6,1761.0
4500687748,16,6,0,3,4,2,1,0,1,0,15527,6.8,18231,223,48,-564,-298,22.3,1552.7,19,4,1,4,3,7,1,1,0,0,16091,7.0,18529,246,67,564,298,24.6,1609.1
4526270984,26,2,0,4,9,3,0,0,0,0,16003,7.2,18376,229,61,-1515,-4,22.9,1600.3,13,4,1,9,4,11,2,1,1,0,17518,7.2,18380,219,56,1515,4,21.9,1751.8
4520610371,17,3,0,9,3,11,0,0,0,0,16954,6.8,17771,221,32,2589,2509,22.1,1695.4,31,5,1,3,9,4,1,1,0,0,14365,6.4,15262,187,46,-2589,-2509,18.7,1436.5
4496865743,16,3,0,3,15,3,0,0,0,0,14281,6.2,13851,183,28,-7666,-5484,18.3,1428.1,19,0,1,15,3,15,1,0,1,1,21947,7.2,19335,231,80,7666,5484,23.1,2194.7
4524720967,15,2,1,12,2,23,0,0,0,0,17628,6.2,14939,184,28,4007,970,18.4,1762.8,17,2,0,2,12,3,0,0,0,0,13621,6.2,13969,183,44,-4007,-970,18.3,1362.1
4525317439,16,1,0,5,5,5,0,0,0,0,15930,6.8,17859,236,48,179,-962,23.6,1593.0,37,3,1,5,5,4,2,1,1,0,15751,7.2,18821,225,52,-179,962,22.5,1575.1
4462358723,15,4,1,5,7,2,0,0,0,0,15210,6.4,15974,172,40,-1656,-1832,17.2,1521.0,13,5,0,7,5,3,0,0,0,0,16866,6.8,17806,219,51,1656,1832,21.9,1686.6
4509303236,13,2,0,6,6,9,1,1,0,0,16239,7.0,18439,203,52,36,-234,20.3,1623.9,19,3,1,6,6,3,0,0,0,0,16203,7.2,18673,224,50,-36,234,22.4,1620.3
4523577373,16,2,1,11,7,13,1,0,1,0,19497,7.2,18445,221,55,3611,2847,22.1,1949.7,15,0,0,7,11,9,0,0,0,0,15886,6.4,15598,165,40,-3611,-2847,16.5,1588.6
4471738335,18,4,1,11,5,12,1,0,1,0,18658,7.0,19117,203,44,1603,1389,20.3,1865.8,14,1,0,5,11,6,0,0,0,0,17055,6.8,17728,229,51,-1603,-1389,22.9,1705.5
4518113467,8,1,0,6,8,5,0,0,0,0,16373,7.2,18479,221,40,-2027,-114,22.1,1637.3,15,1,1,8,6,9,2,1,1,0,18400,7.0,18593,235,36,2027,114,23.5,1840.0
4525586479,56,6,1,7,6,9,1,0,1,0,16647,6.6,17867,214,60,-206,-363,21.4,1664.7,16,5,0,6,7,10,1,1,0,0,16853,7.0,18230,238,39,206,363,23.8,1685.3
4489459707,17,2,0,7,7,8,0,0,0,0,16983,6.8,17858,227,51,-355,-560,22.7,1698.3,18,5,1,7,7,10,1,1,0,0,17338,7.0,18418,218,71,355,560,21.8,1733.8
4515997665,12,5,1,5,6,7,0,0,0,0,16688,7.0,18697,247,49,1008,-248,24.7,1668.8,44,3,0,6,5,5,1,1,0,0,15680,7.4,18945,199,51,-1008,248,19.9,1568.0
4518585607,28,3,0,3,7,3,0,0,0,0,15423,7.2,18648,232,52,-2055,-860,23.2,1542.3,18,2,1,7,3,10,1,1,0,0,17478,7.2,19508,258,52,2055,860,25.8,1747.8
4517748095,14,1,0,5,14,6,2,1,1,0,15015,6.6,16032,167,54,-5065,-3552,16.7,1501.5,16,1,1,14,5,9,0,0,0,0,20080,7.4,19584,224,52,5065,3552,22.4,2008.0
4479796051,18,4,0,7,4,11,0,0,0,0,17321,7.2,18397,233,41,2091,2518,23.3,1732.1,19,4,1,4,7,6,1,1,0,0,15230,6.6,15879,204,60,-2091,-2518,20.4,1523.0
4524677634,19,1,1,7,4,11,0,0,0,0,16867,7.2,18904,219,57,920,1488,21.9,1686.7,18,2,0,4,7,6,1,1,0,0,15947,7.0,17416,210,54,-920,-1488,21.0,1594.7
4466130719,15,2,0,6,2,9,2,1,1,0,16260,6.8,17559,224,49,1481,528,22.4,1626.0,15,3,1,2,6,5,0,0,0,0,14779,6.6,17031,195,64,-1481,-528,19.5,1477.9
4513456428,18,5,1,11,6,13,1,1,0,0,18214,7.2,19670,220,52,2262,2885,22.0,1821.4,18,4,0,6,11,6,0,0,0,0,15952,6.6,16785,228,34,-2262,-2885,22.8,1595.2
4524387614,36,4,1,6,2,4,1,1,0,0,16432,7.4,18849,208,59,2390,1778,20.8,1643.2,15,5,0,2,6,1,0,0,0,0,14042,6.6,17071,219,48,-2390,-1778,21.9,1404.2
4500853153,18,0,0,5,11,4,0,0,0,0,15534,6.2,15681,209,43,-2840,-1360,20.9,1553.4,17,2,1,11,5,11,0,0,0,0,18374,7.0,17041,198,57,2840,1360,19.8,1837.4
4521688394,15,4,0,4,4,5,0,0,0,0,16333,7.2,19527,237,65,60,-341,23.7,1633.3,23,5,1,4,4,3,1,1,0,0,16273,7.6,19868,252,80,-60,341,25.2,1627.3
4473962566,17,2,0,9,7,10,1,1,0,0,17205,7.0,18124,218,40,721,2077,21.8,1720.5,16,1,1,7,9,11,0,0,0,0,16484,6.4,16047,212,39,-721,-2077,21.2,1648.4
4523749055,15,3,0,10,6,9,2,1,1,2,19197,7.2,18449,219,53,2941,1850,21.9,1919.7,15,6,1,6,10,6,0,0,0,0,16256,6.6,16599,192,52,-2941,-1850,19.2,1625.6
4525924001,16,12,1,9,4,8,1,1,0,0,17915,7.0,19615,225,56,1963,781,22.5,1791.5,36,4,0,4,9,1,0,0,0,0,15952,7.2,18834,258,56,-1963,-781,25.8,1595.2
4524213588,13,1,0,7,5,6,1,0,1,0,17042,7.4,19460,207,60,934,776,20.7,1704.2,9,0,1,5,7,4,0,0,0,0,16108,7.4,18684,248,48,-934,-776,24.8,1610.8
4525369835,41,2,0,2,7,4,1,1,0,0,15032,7.0,18462,232,68,-2785,-453,23.2,1503.2,22,3,1,7,2,7,1,0,1,0,17817,7.2,18915,228,55,2785,453,22.8,1781.7
4485702614,11,1,0,2,4,0,0,0,0,0,14395,6.6,17060,210,43,-1386,-335,21.0,1439.5,16,1,1,4,2,6,0,0,0,0,15781,6.8,17395,211,60,1386,335,21.1,1578.1
4515396713,13,3,1,5,4,5,1,0,1,0,16582,6.8,18262,216,66,380,-239,21.6,1658.2,58,4,0,4,5,6,1,1,0,0,16202,6.8,18501,246,41,-380,239,24.6,1620.2
4524225995,26,1,1,9,5,12,1,1,0,0,17501,7.0,17203,195,45,3195,1056,19.5,1750.1,14,6,0,5,9,4,0,0,0,0,14306,6.4,16147,166,36,-3195,-1056,16.6,1430.6
4526575643,18,4,0,4,6,6,0,0,0,0,14827,6.6,16610,187,43,-2322,-1522,18.7,1482.7,13,5,1,6,4,5,1,1,0,0,17149,7.0,18132,222,68,2322,1522,22.2,1714.9
4474087282,41,3,0,6,4,5,0,0,0,0,15724,6.8,17512,217,46,81,1865,21.7,1572.4,21,3,1,4,6,7,1,1,0,0,15643,6.4,15647,219,58,-81,-1865,21.9,1564.3
4519443312,16,3,0,6,11,8,1,1,0,0,15930,6.8,17257,200,43,-3549,-2407,20.0,1593.0,14,4,1,11,6,12,0,0,0,0,19479,7.4,19664,214,60,3549,2407,21.4,1947.9
4445714594,15,7,1,6,6,5,1,0,1,0,15965,6.8,17701,213,40,-865,-20,21.3,1596.5,62,1,0,6,6,7,1,1,0,0,16830,7.0,17721,204,59,865,20,20.4,1683.0
4509977321,12,4,0,2,5,1,0,0,0,0,14349,7.0,17864,199,62,-2289,-277,19.9,1434.9,20,1,1,5,2,4,1,1,0,0,16638,7.2,18141,246,57,2289,277,24.6,1663.8
4495029898,15,6,1,5,2,9,0,0,0,0,16113,7.0,18642,236,53,1277,1357,23.6,1611.3,21,4,0,2,5,4,1,1,0,0,14836,6.8,17285,221,54,-1277,-1357,22.1,1483.6
4457833160,20,2,1,9,6,10,1,1,0,0,16836,6.6,17688,186,48,312,-613,18.6,1683.6,18,3,0,6,9,4,0,0,0,0,16524,6.8,18301,215,54,-312,613,21.5,1652.4
4524924561,14,2,0,3,6,4,0,0,0,0,16354,7.0,17848,252,46,176,-172,25.2,1635.4,51,3,1,6,3,7,1,1,0,0,16178,6.8,18020,202,55,-176,172,20.2,1617.8
4438257769,12,2,0,5,6,9,1,1,0,0,15011,6.4,15341,173,50,-1071,-1810,17.3,1501.1,19,1,1,6,5,3,0,0,0,0,16082,6.6,17151,226,44,1071,1810,22.6,1608.2
4491473852,18,3,0,3,7,5,0,0,0,0,15144,6.8,17285,224,50,-2283,-1969,22.4,1514.4,47,2,1,7,3,9,1,1,0,0,17427,7.2,19254,259,62,2283,1969,25.9,1742.7
4467077556,17,3,0,1,5,1,0,0,0,0,14777,6.8,17674,231,59,-1664,-990,23.1,1477.7,47,3,1,5,1,7,1,0,1,0,16441,7.2,18664,236,46,1664,990,23.6,1644.1
4520572542,18,3,0,5,5,10,1,1,0,0,16138,6.6,16397,208,54,-732,-813,20.8,1613.8,17,0,1,5,5,4,1,0,1,1,16870,6.8,17210,218,40,732,813,21.8,1687.0
4523902957,15,3,1,7,3,10,1,1,0,0,16578,7.0,18139,200,62,1159,1510,20.0,1657.8,14,2,0,3,7,3,0,0,0,0,15419,6.6,16629,250,41,-1159,-1510,25.0,1541.9
4513381950,15,11,1,4,1,2,1,1,0,0,15304,7.0,18188,228,48,1093,720,22.8,1530.4,46,1,0,1,4,1,0,0,0,0,14211,6.8,17468,215,56,-1093,-720,21.5,1421.1
4514596262,46,5,0,2,7,2,0,0,0,0,14242,6.6,17184,212,50,-2954,-1250,21.2,1424.2,15,5,1,7,2,3,1,0,1,0,17196,7.0,18434,244,52,2954,1250,24.4,1719.6
4519318813,11,1,1,6,4,6,1,1,0,0,15437,6.6,16652,198,52,-152,-901,19.8,1543.7,17,3,0,4,6,6,1,0,1,0,15589,7.0,17553,220,49,152,901,22.0,1558.9
4440425565,16,2,0,13,6,13,2,1,1,2,22162,7.8,21254,249,72,6578,5388,24.9,2216.2,10,2,1,6,13,7,0,0,0,0,15584,6.2,15866,156,68,-6578,-5388,15.6,1558.4
4477722097,13,2,1,3,1,4,1,0,1,0,16156,7.0,18605,233,61,1639,1308,23.3,1615.6,14,4,0,1,3,3,1,1,0,0,14517,7.0,17297,241,40,-1639,-1308,24.1,1451.7
4525188268,14,4,1,8,4,14,1,1,0,0,17451,6.8,17118,210,53,2470,1058,21.0,1745.1,14,1,0,4,8,3,0,0,0,0,14981,6.6,16060,219,30,-2470,-1058,21.9,1498.1
4499534463,82,2,1,10,5,9,2,1,1,0,18408,7.4,19955,208,73,1917,1186,20.8,1840.8,16,3,0,5,10,4,0,0,0,0,16491,7.0,18769,211,41,-1917,-1186,21.1,1649.1
4483696050,15,6,1,10,6,11,1,1,0,0,19380,7.2,19467,244,64,3844,2740,24.4,1938.0,17,4,0,6,10,6,0,0,0,0,15536,6.4,16727,189,46,-3844,-2740,18.9,1553.6
4526149121,13,2,0,1,6,1,1,1,0,0,14289,6.8,16754,220,56,-2946,-2952,22.0,1428.9,17,1,1,6,1,7,0,0,0,0,17235,7.2,19706,223,67,2946,2952,22.3,1723.5
4516712526,20,2,1,11,4,11,1,1,0,0,19035,7.4,19997,232,43,2739,1170,23.2,1903.5,16,2,0,4,11,5,1,0,1,0,16296,7.2,18827,268,44,-2739,-1170,26.8,1629.6
4465399083,15,2,0,1,7,1,0,0,0,0,13745,6.6,16710,198,55,-3426,-997,19.8,1374.5,72,4,1,7,1,9,1,1,0,0,17171,7.0,17707,212,60,3426,997,21.2,1717.1
4486380071,11,5,1,7,16,7,0,0,0,0,16711,6.4,15855,201,51,-3289,-4291,20.1,1671.1,15,1,0,16,7,17,1,0,1,0,20000,7.4,20146,201,49,3289,4291,20.1,2000.0
4490887510,14,3,0,6,7,6,0,0,0,0,16404,6.8,18840,245,48,-919,47,24.5,1640.4,112,3,1,7,6,10,0,0,0,0,17323,7.2,18793,219,50,919,-47,21.9,1732.3
4486764809,16,4,0,1,3,1,1,0,1,0,14605,7.0,17830,244,48,-280,903,24.4,1460.5,14,3,1,3,1,3,1,1,0,0,14885,6.6,16927,217,60,280,-903,21.7,1488.5
4518528928,54,1,0,8,3,8,0,0,0,0,17101,7.0,17725,214,40,2294,1989,21.4,1710.1,18,3,1,3,8,6,2,1,1,0,14807,6.4,15736,182,48,-2294,-1989,18.2,1480.7
4496746747,55,3,1,7,5,5,0,0,0,0,16812,7.0,19678,228,56,1322,2276,22.8,1681.2,17,4,0,5,7,5,1,1,0,0,15490,6.6,17402,215,64,-1322,-2276,21.5,1549.0
4521752199,20,1,0,1,5,1,1,1,0,0,14358,6.6,16468,203,56,-3071,-2267,20.3,1435.8,15,2,1,5,1,2,1,0,1,1,17429,7.0,18735,242,56,3071,2267,24.2,1742.9
4527033162,13,3,0,6,9,7,0,0,0,0,15827,6.8,17027,181,46,-2327,-2250,18.1,1582.7,17,2,1,9,6,5,2,1,1,0,18154,7.4,19277,251,60,2327,2250,25.1,1815.4
4505644986,15,1,1,6,4,8,1,1,0,0,17142,7.2,18300,227,56,576,-1839,22.7,1714.2,15,1,0,4,6,7,1,0,1,0,16566,7.4,20139,222,79,-576,1839,22.2,1656.6
4500070797,14,3,0,5,7,2,0,0,0,0,14318,6.6,16916,180,45,-1575,-1224,18.0,1431.8,14,0,1,7,5,5,1,1,0,0,15893,7.0,18140,193,50,1575,1224,19.3,1589.3
4522859590,15,1,1,11,4,10,0,0,0,1,19677,6.8,17356,217,45,6581,3949,21.7,1967.7,14,1,0,4,11,5,0,0,0,0,13096,5.8,13407,132,39,-6581,-3949,13.2,1309.6
4515910414,15,3,1,11,10,10,1,0,1,0,18145,7.2,18705,211,40,-139,-652,21.1,1814.5,14,3,0,10,11,8,1,1,0,0,18284,7.2,19357,236,50,139,652,23.6,1828.4
4525999060,46,2,0,3,6,0,1,0,1,0,14984,7.0,18050,235,64,-1287,-746,23.5,1498.4,19,3,1,6,3,3,1,1,0,0,16271,7.0,18796,237,58,1287,746,23.7,1627.1
4508352698,18,4,0,1,5,0,0,0,0,0,13533,6.4,15497,212,35,-2191,-1498,21.2,1353.3,42,5,1,5,1,9,1,1,0,0,15724,6.8,16995,207,50,2191,1498,20.7,1572.4
4518980020,11,0,0,6,4,3,0,0,0,0,16796,7.4,19792,256,59,311,707,25.6,1679.6,15,3,1,4,6,4,1,1,0,0,16485,7.2,19085,241,66,-311,-707,24.1,1648.5
4465964389,36,6,0,4,8,7,0,0,0,0,14795,6.6,16491,190,36,-3431,-1020,19.0,1479.5,27,1,1,8,4,11,1,1,0,0,18226,6.8,17511,221,47,3431,1020,22.1,1822.6
4477297316,16,2,1,4,3,3,1,0,1,2,17048,6.6,17678,206,48,2575,997,20.6,1704.8,14,3,0,3,4,4,1,1,0,0,14473,6.8,16681,214,43,-2575,-997,21.4,1447.3
4497572230,17,5,0,3,10,3,0,0,0,0,14635,6.6,16718,202,41,-3709,-1017,20.2,1463.5,16,3,1,10,3,10,1,1,0,0,18344,6.8,17735,231,39,3709,1017,23.1,1834.4
4521738824,16,3,1,4,7,5,1,1,0,0,16418,6.8,17454,237,50,217,72,23.7,1641.8,16,0,0,7,4,5,0,0,0,0,16201,6.6,17382,216,40,-217,-72,21.6,1620.1
4520645604,156,0,1,10,6,15,2,1,1,1,20183,7.6,20663,216,73,3663,2748,21.6,2018.3,14,1,0,6,10,6,0,0,0,0,16520,6.8,17915,192,47,-3663,-2748,19.2,1652.0
4519427485,24,4,1,6,4,8,0,0,0,0,16505,6.8,17567,205,52,805,149,20.5,1650.5,13,8,0,4,6,4,1,1,0,0,15700,7.0,17418,256,44,-805,-149,25.6,1570.0
4510202032,18,4,0,6,8,5,0,0,0,0,15476,6.8,17206,187,36,-2403,-2787,18.7,1547.6,139,5,1,8,6,9,1,1,0,0,17879,7.4,19993,243,53,2403,2787,24.3,1787.9
4501342795,18,3,1,9,7,12,1,1,0,0,18920,7.4,19580,238,44,2339,625,23.8,1892.0,13,3,0,7,9,5,0,0,0,0,16581,7.0,18955,220,39,-2339,-625,22.0,1658.1
4524580424,16,1,1,9,7,14,1,0,1,0,17465,6.6,17463,211,40,875,276,21.1,1746.5,13,2,0,7,9,7,0,0,0,0,16590,6.6,17187,183,44,-875,-276,18.3,1659.0
4505405974,18,4,0,3,4,3,0,0,0,0,14511,6.6,16462,212,42,-342,-2245,21.2,1451.1,18,2,1,4,3,1,1,1,0,0,14853,7.4,18707,212,43,342,2245,21.2,1485.3
4522593287,17,2,1,3,8,4,0,0,0,0,14037,6.2,15309,167,54,-2491,-2521,16.7,1403.7,35,3,0,8,3,6,2,1,1,0,16528,7.0,17830,202,36,2491,2521,20.2,1652.8
4516563869,14,4,1,8,6,10,1,1,0,0,17776,6.8,18126,224,45,1072,411,22.4,1777.6,17,2,0,6,8,8,0,0,0,0,16704,6.6,17715,238,51,-1072,-411,23.8,1670.4
4519787212,19,2,0,5,6,5,2,1,1,0,15594,7.0,18180,201,56,-1328,333,20.1,1559.4,23,4,1,6,5,7,0,0,0,0,16922,6.8,17847,227,60,1328,-333,22.7,1692.2
4511770317,15,2,0,8,6,8,1,1,0,0,16627,6.8,17397,212,50,166,-497,21.2,1662.7,14,0,1,6,8,6,1,0,1,0,16461,7.0,17894,209,53,-166,497,20.9,1646.1
4512489523,50,4,0,5,4,8,1,1,0,0,16560,6.8,18049,220,49,1319,111,22.0,1656.0,37,2,1,4,5,5,1,0,1,0,15241,7.0,17938,190,51,-1319,-111,19.0,1524.1
4526781753,16,4,1,8,3,12,1,1,0,0,17479,7.2,19021,243,48,2143,1315,24.3,1747.9,17,5,0,3,8,4,0,0,0,0,15336,7.0,17706,203,44,-2143,-1315,20.3,1533.6
4524502451,16,3,1,4,4,3,1,1,0,0,15620,7.0,17974,225,52,234,-318,22.5,1562.0,89,2,0,4,4,4,0,0,0,0,15386,7.0,18292,227,40,-234,318,22.7,1538.6
4520723011,35,2,1,5,0,4,1,1,0,0,17434,7.2,18954,257,54,4612,3848,25.7,1743.4,11,1,0,0,5,0,0,0,0,0,12822,6.4,15106,203,44,-4612,-3848,20.3,1282.2
4478024561,17,3,1,7,8,2,1,1,0,0,16443,6.8,17912,228,48,-1041,-661,22.8,1644.3,13,3,0,8,7,9,0,0,0,0,17484,7.0,18573,216,47,1041,661,21.6,1748.4
4523099371,15,0,0,6,6,6,1,1,0,0,15738,7.0,17430,206,52,-360,-708,20.6,1573.8,18,2,1,6,6,1,1,0,1,0,16098,7.0,18138,230,60,360,708,23.0,1609.8
4527471301,19,8,0,7,4,10,0,0,0,0,16507,6.4,16273,212,42,1114,-1294,21.2,1650.7,18,4,1,4,7,5,0,0,0,0,15393,6.8,17567,221,55,-1114,1294,22.1,1539.3
4458486067,14,3,1,6,7,6,0,0,0,0,16643,7.0,18042,232,47,-265,-872,23.2,1664.3,15,1,0,7,6,9,1,1,0,0,16908,7.2,18914,222,60,265,872,22.2,1690.8
4517848263,16,1,1,5,3,5,2,1,1,2,17645,7.0,18081,224,52,2864,1182,22.4,1764.5,74,3,0,3,5,3,0,0,0,0,14781,6.6,16899,207,40,-2864,-1182,20.7,1478.1
4495691730,11,0,1,5,9,5,0,0,0,0,15081,6.2,15753,195,41,-1492,-1219,19.5,1508.1,19,2,0,9,5,14,0,0,0,0,16573,6.6,16972,218,22,1492,1219,21.8,1657.3
4492308589,15,5,1,5,8,6,0,0,0,0,15627,6.8,17457,199,56,-2690,-3245,19.9,1562.7,58,1,0,8,5,9,2,1,1,0,18317,7.6,20702,230,92,2690,3245,23.0,1831.7
4455400959,35,3,1,8,3,13,0,0,0,0,17325,7.0,18380,217,26,3454,2249,21.7,1732.5,14,0,0,3,8,3,1,1,0,0,13871,6.8,16131,193,48,-3454,-2249,19.3,1387.1
4496832374,18,2,0,9,6,11,1,1,0,0,18077,6.8,17869,235,40,1669,113,23.5,1807.7,16,3,1,6,9,4,0,0,0,0,16408,7.0,17756,218,48,-1669,-113,21.8,1640.8
4467109109,15,4,1,5,12,3,0,0,0,0,16358,6.8,17640,206,56,-2651,-1695,20.6,1635.8,16,5,0,12,5,14,0,0,0,0,19009,7.2,19335,218,64,2651,1695,21.8,1900.9
4501540670,79,2,1,7,7,4,0,0,0,1,18053,7.4,19492,230,41,891,1526,23.0,1805.3,14,1,0,7,7,11,1,1,0,0,17162,7.0,17966,202,54,-891,-1526,20.2,1716.2
4524739692,15,3,0,7,6,9,1,1,0,1,18551,7.2,18363,225,61,1850,834,22.5,1855.1,18,1,1,6,7,7,0,0,0,0,16701,7.0,17529,210,57,-1850,-834,21.0,1670.1
4523485594,26,2,1,10,5,6,0,0,0,0,17915,7.4,19494,222,62,2833,3175,22.2,1791.5,14,4,0,5,10,6,0,0,0,0,15082,6.6,16319,206,25,-2833,-3175,20.6,1508.2
4523523934,10,2,0,5,13,3,0,0,0,0,15126,6.8,16897,206,31,-4864,-2252,20.6,1512.6,15,3,1,13,5,11,0,0,0,0,19990,7.4,19149,217,57,4864,2252,21.7,1999.0
4523620825,14,4,1,13,3,13,1,1,0,2,22049,7.4,19632,243,51,8532,5876,24.3,2204.9,15,2,0,3,13,2,0,0,0,0,13517,5.8,13756,165,46,-8532,-5876,16.5,1351.7
4519236802,51,1,0,2,14,3,1,0,1,0,13612,6.4,15504,181,48,-6717,-4767,18.1,1361.2,14,5,1,14,2,17,1,1,0,0,20329,7.6,20271,226,56,6717,4767,22.6,2032.9
4482930107,15,1,0,14,4,13,0,0,0,1,20319,7.2,18956,216,57,5774,2869,21.6,2031.9,17,2,1,4,14,1,0,0,0,0,14545,6.4,16087,218,34,-5774,-2869,21.8,1454.5
4466772650,25,3,0,3,8,1,0,0,0,0,14868,6.6,16222,237,41,-3346,-3153,23.7,1486.8,18,5,1,8,3,9,2,1,1,0,18214,7.2,19375,229,52,3346,3153,22.9,1821.4
4491503560,20,2,0,11,7,12,0,0,0,0,17649,7.2,18664,187,42,604,1983,18.7,1764.9,16,1,1,7,11,8,1,1,0,0,17045,6.6,16681,187,62,-604,-1983,18.7,1704.5
4478456612,40,6,0,4,4,5,0,0,0,0,15894,7.0,18853,223,60,310,536,22.3,1589.4,19,5,1,4,4,4,1,1,0,0,15584,7.0,18317,223,54,-310,-536,22.3,1558.4
4527576450,13,2,0,4,8,3,0,0,0,0,14668,6.6,16865,193,32,-2958,-1446,19.3,1466.8,15,2,1,8,4,9,1,1,0,0,17626,7.0,18311,232,43,2958,1446,23.2,1762.6
4524900733,16,1,0,6,9,3,1,1,0,0,15704,6.6,17114,199,52,-1332,-2004,19.9,1570.4,14,6,1,9,6,10,0,0,0,0,17036,7.2,19118,217,40,1332,2004,21.7,1703.6
4526369291,31,2,1,5,14,2,2,1,1,0,16431,6.6,16968,219,64,-3488,-2682,21.9,1643.1,15,3,0,14,5,18,0,0,0,0,19919,7.4,19650,240,43,3488,2682,24.0,1991.9
4454291477,15,0,0,5,10,1,0,0,0,0,15605,7.0,19324,216,58,-2048,-29,21.6,1560.5,12,0,1,10,5,13,1,1,0,0,17653,7.4,19353,221,52,2048,29,22.1,1765.3
4464829363,163,1,0,4,4,4,1,1,0,0,15639,7.0,18956,230,60,-1233,270,23.0,1563.9,17,5,1,4,4,5,0,0,0,0,16872,7.2,18686,243,56,1233,-270,24.3,1687.2
4521580882,18,3,0,5,5,3,2,1,1,0,15193,6.8,16642,208,50,-404,-419,20.8,1519.3,39,4,1,5,5,11,0,0,0,0,15597,6.8,17061,216,42,404,419,21.6,1559.7
4521244850,13,0,1,11,5,11,2,1,1,0,19181,7.4,19634,247,50,3153,3196,24.7,1918.1,12,2,0,5,11,10,0,0,0,0,16028,6.6,16438,185,61,-3153,-3196,18.5,1602.8
4517486439,19,3,1,8,2,12,0,0,0,0,17432,7.2,18495,209,44,2673,1388,20.9,1743.2,11,2,0,2,8,4,1,1,0,0,14759,6.6,17107,216,64,-2673,-1388,21.6,1475.9
4519998999,14,2,0,0,4,0,1,0,1,0,13805,6.8,17253,221,52,-2009,-2396,22.1,1380.5,59,1,1,4,0,5,1,1,0,0,15814,7.2,19649,243,59,2009,2396,24.3,1581.4
4447986050,20,6,1,11,8,12,1,1,0,0,19349,7.2,19673,219,51,2445,1807,21.9,1934.9,15,2,0,8,11,10,0,0,0,0,16904,6.8,17866,194,48,-2445,-1807,19.4,1690.4
4516583288,12,2,0,4,10,4,1,1,0,0,15994,7.0,18031,229,64,-2519,-1610,22.9,1599.4,15,4,1,10,4,15,0,0,0,0,18513,7.2,19641,238,39,2519,1610,23.8,1851.3
4512775669,13,2,1,5,2,5,1,1,0,0,15767,7.0,17413,224,52,384,-690,22.4,1576.7,16,3,0,2,5,3,1,0,1,0,15383,7.0,18103,250,48,-384,690,25.0,1538.3
4472483704,65,2,0,3,8,5,0,0,0,0,14823,6.8,17193,193,56,-3916,-1400,19.3,1482.3,23,5,1,8,3,7,2,1,1,1,18739,7.0,18593,245,53,3916,1400,24.5,1873.9
4520327496,26,4,0,5,3,7,0,0,0,0,16784,7.0,18136,252,56,727,-566,25.2,1678.4,13,0,1,3,5,2,0,0,0,0,16057,7.2,18702,221,55,-727,566,22.1,1605.7
4515999834,16,1,1,10,10,13,0,0,0,0,17917,6.8,17997,199,44,-1074,-1029,19.9,1791.7,18,2,0,10,10,9,1,1,0,0,18991,7.2,19026,233,56,1074,1029,23.3,1899.1
4490735415,17,3,0,7,4,5,1,1,0,0,16819,7.2,18725,239,60,707,1960,23.9,1681.9,37,2,1,4,7,3,0,0,0,0,16112,6.8,16765,198,52,-707,-1960,19.8,1611.2
4461378771,16,2,1,11,10,8,1,0,1,0,18762,7.0,18724,202,40,1378,1187,20.2,1876.2,15,2,0,10,11,6,0,0,0,0,17384,7.0,17537,212,52,-1378,-1187,21.2,1738.4
4520775356,14,3,1,11,2,8,2,1,1,0,19354,7.2,20036,251,48,5462,3677,25.1,1935.4,15,0,0,2,11,2,0,0,0,0,13892,6.8,16359,192,51,-5462,-3677,19.2,1389.2
4484391297,13,2,0,4,4,0,1,0,1,1,17079,7.4,19361,250,66,1680,2384,25.0,1707.9,50,2,1,4,4,3,0,0,0,0,15399,6.6,16977,200,62,-1680,-2384,20.0,1539.9
4472293510,14,1,0,1,4,1,0,0,0,0,14588,6.8,17460,241,45,-2574,-404,24.1,1458.8,11,3,1,4,1,6,0,0,0,1,17162,6.8,17864,222,47,2574,404,22.2,1716.2
4525337352,14,4,0,4,5,1,1,1,0,0,15202,7.0,18246,240,56,-947,1016,24.0,1520.2,17,2,1,5,4,7,0,0,0,0,16149,6.8,17230,231,46,947,-1016,23.1,1614.9
4459502847,16,1,0,8,4,10,1,0,1,0,16696,7.0,17832,206,44,865,1006,20.6,1669.6,10,1,1,4,8,3,0,0,0,0,15831,6.6,16826,220,39,-865,-1006,22.0,1583.1
4523893279,15,2,0,5,10,8,1,1,0,0,15269,6.6,16739,194,37,-2793,-1055,19.4,1526.9,15,1,1,10,5,13,0,0,0,0,18062,6.8,17794,204,45,2793,1055,20.4,1806.2
4519249108,16,3,0,0,6,0,0,0,0,0,12698,6.2,15550,195,48,-3784,-4019,19.5,1269.8,13,2,1,6,0,11,1,1,0,0,16482,7.4,19569,222,60,3784,4019,22.2,1648.2
4481763565,16,3,1,10,9,9,1,1,0,0,17098,6.8,17045,201,35,-635,-1011,20.1,1709.8,18,6,0,9,10,9,0,0,0,0,17733,7.2,18056,208,54,635,1011,20.8,1773.3
4527061275,14,2,0,5,8,4,0,0,0,0,15921,6.8,17466,203,40,-1110,-721,20.3,1592.1,14,2,1,8,5,6,0,0,0,0,17031,7.2,18187,215,49,1110,721,21.5,1703.1
4523720139,13,2,1,1,1,0,1,0,1,0,14737,7.0,18532,229,59,92,728,22.9,1473.7,11,2,0,1,1,0,0,0,0,0,14645,6.8,17804,199,59,-92,-728,19.9,1464.5
4526431738,12,4,0,3,8,3,0,0,0,0,14264,6.2,15870,201,28,-2234,-2021,20.1,1426.4,16,2,1,8,3,6,1,1,0,0,16498,6.8,17891,204,56,2234,2021,20.4,1649.8
4503948096,15,2,1,7,3,4,1,1,0,0,16656,6.8,17435,214,67,1786,-261,21.4,1665.6,15,1,0,3,7,3,0,0,0,0,14870,6.8,17696,206,49,-1786,261,20.6,1487.0
4443355005,39,3,1,5,5,4,2,1,1,0,14527,6.8,17128,195,45,-1063,63,19.5,1452.7,18,0,0,5,5,4,0,0,0,0,15590,6.8,17065,217,48,1063,-63,21.7,1559.0
4477114963,10,7,0,10,4,13,0,0,0,0,18959,7.0,19305,220,48,3522,1996,22.0,1895.9,16,3,1,4,10,5,1,1,0,0,15437,6.6,17309,206,69,-3522,-1996,20.6,1543.7
4526240730,16,2,1,10,11,18,1,1,0,0,18588,7.4,18787,205,65,432,1389,20.5,1858.8,20,3,0,11,10,12,0,0,0,0,18156,6.8,17398,186,45,-432,-1389,18.6,1815.6
4525110987,14,5,1,10,7,8,1,1,0,0,18302,7.2,19223,237,47,851,709,23.7,1830.2,16,3,0,7,10,8,0,0,0,0,17451,7.0,18514,251,51,-851,-709,25.1,1745.1
4518121275,20,1,1,7,6,8,1,1,0,0,16417,6.8,17202,205,56,161,130,20.5,1641.7,11,2,0,6,7,11,0,0,0,0,16256,6.8,17072,209,60,-161,-130,20.9,1625.6
4479126740,61,3,0,8,10,8,0,0,0,0,16780,6.8,17484,209,39,-1226,48,20.9,1678.0,18,4,1,10,8,12,1,1,0,0,18006,6.8,17436,225,36,1226,-48,22.5,1800.6
4459961160,22,5,0,6,11,8,0,0,0,0,17171,6.8,18333,254,32,-1882,-1917,25.4,1717.1,25,9,1,11,6,6,2,1,1,0,19053,7.6,20250,218,60,1882,1917,21.8,1905.3
4518028905,16,2,1,8,9,5,0,0,0,0,16560,6.8,17640,200,47,-1611,-1380,20.0,1656.0,19,4,0,9,8,9,1,1,0,0,18171,7.2,19020,209,56,1611,1380,20.9,1817.1
4462529490,16,4,0,11,13,13,1,1,0,0,18549,6.8,16837,182,56,-1048,-450,18.2,1854.9,15,4,1,13,11,17,1,0,1,1,19597,6.8,17287,201,40,1048,450,20.1,1959.7
4519099479,16,2,0,7,6,8,0,0,0,0,16286,7.0,17910,223,40,369,561,22.3,1628.6,15,1,1,6,7,8,0,0,0,0,15917,7.0,17349,196,52,-369,-561,19.6,1591.7
4516851869,13,3,1,2,9,0,1,1,0,0,13803,6.6,16366,203,55,-4410,-4163,20.3,1380.3,12,1,0,9,2,3,1,0,1,0,18213,7.4,20529,236,72,4410,4163,23.6,1821.3
4523300561,12,1,1,11,2,9,1,1,0,0,19280,7.6,20813,252,51,5041,3996,25.2,1928.0,19,4,0,2,11,3,0,0,0,0,14239,6.8,16817,215,59,-5041,-3996,21.5,1423.9
4502931082,14,0,0,6,7,5,0,0,0,0,15903,7.0,18823,205,53,-623,1024,20.5,1590.3,14,1,1,7,6,5,1,1,0,0,16526,7.0,17799,205,48,623,-1024,20.5,1652.6
4515883864,15,4,1,8,4,9,1,1,0,0,16955,6.8,17434,191,56,1306,1039,19.1,1695.5,16,0,0,4,8,2,0,0,0,0,15649,6.6,16395,200,48,-1306,-1039,20.0,1564.9
4517200256,18,5,0,7,8,6,0,0,0,0,16423,7.2,18901,212,60,-859,919,21.2,1642.3,17,3,1,8,7,6,0,0,0,0,17282,7.0,17982,226,43,859,-919,22.6,1728.2
4515957232,52,2,0,2,10,1,0,0,0,0,14817,6.4,16953,212,60,-3264,-1507,21.2,1481.7,16,2,1,10,2,11,1,1,0,0,18081,7.0,18460,211,40,3264,1507,21.1,1808.1
4524640273,16,1,1,7,5,7,0,0,0,0,16602,7.0,17918,211,59,888,1005,21.1,1660.2,22,1,0,5,7,4,0,0,0,0,15714,7.0,16913,227,33,-888,-1005,22.7,1571.4
4527522353,17,7,0,10,7,9,1,1,0,0,17712,7.0,19043,207,42,2370,3795,20.7,1771.2,18,3,1,7,10,6,0,0,0,0,15342,6.4,15248,186,38,-2370,-3795,18.6,1534.2
4523668637,54,2,1,8,4,6,2,1,1,0,16774,7.2,18465,240,48,300,-568,24.0,1677.4,12,2,0,4,8,5,0,0,0,0,16474,7.4,19033,231,68,-300,568,23.1,1647.4
4521616991,23,3,1,5,1,6,1,1,0,0,17196,7.2,19002,239,64,2973,1440,23.9,1719.6,17,7,0,1,5,2,0,0,0,0,14223,6.8,17562,239,48,-2973,-1440,23.9,1422.3
4521835060,42,3,0,8,13,8,0,0,0,0,17639,6.6,16561,194,48,-887,-501,19.4,1763.9,51,5,1,13,8,20,1,1,0,0,18526,6.8,17062,198,36,887,501,19.8,1852.6
4522643294,13,13,0,4,9,8,0,0,0,0,15400,6.6,16910,219,34,-2564,-1518,21.9,1540.0,38,1,1,9,4,10,0,0,0,0,17964,6.8,18428,229,56,2564,1518,22.9,1796.4
4447547106,13,3,0,2,3,3,0,0,0,0,14752,6.8,17798,230,53,-439,-983,23.0,1475.2,36,0,1,3,2,3,2,1,1,0,15191,7.2,18781,222,65,439,983,22.2,1519.1
4458685012,15,3,1,9,3,11,0,0,0,0,18584,7.0,18383,203,70,3093,1285,20.3,1858.4,17,2,0,3,9,5,0,0,0,0,15491,6.8,17098,212,41,-3093,-1285,21.2,1549.1
4458803817,15,5,1,11,8,13,0,0,0,1,18723,6.8,17268,188,35,1844,-34,18.8,1872.3,19,0,0,8,11,6,1,1,0,0,16879,6.6,17302,210,40,-1844,34,21.0,1687.9
4524850374,26,3,0,8,8,8,0,0,0,0,16357,6.6,16464,193,37,-232,97,19.3,1635.7,16,2,1,8,8,8,1,1,0,0,16589,6.6,16367,196,56,232,-97,19.6,1658.9
4524682251,16,5,1,10,3,8,1,1,0,0,17953,7.2,18275,213,35,2915,2085,21.3,1795.3,19,2,0,3,10,6,0,0,0,0,15038,6.4,16190,200,48,-2915,-2085,20.0,1503.8
4526858516,18,6,1,1,5,0,1,1,0,0,14524,6.4,16989,234,64,-2527,-1697,23.4,1452.4,18,3,0,5,1,7,1,0,1,0,17051,7.0,18686,238,42,2527,1697,23.8,1705.1
4453299408,41,3,1,8,10,10,1,1,0,0,16526,7.0,18130,174,44,-2720,-2680,17.4,1652.6,19,5,0,10,8,7,0,0,0,0,19246,7.6,20810,239,79,2720,2680,23.9,1924.6
4494500781,18,5,0,6,9,7,2,1,1,0,18050,7.2,18264,238,60,284,681,23.8,1805.0,58,5,1,9,6,15,0,0,0,0,17766,6.8,17583,207,52,-284,-681,20.7,1776.6
4468973214,23,1,0,4,7,6,0,0,0,0,15210,6.6,16010,207,40,-2161,-3222,20.7,1521.0,35,1,1,7,4,8,2,1,1,0,17371,7.4,19232,214,72,2161,3222,21.4,1737.1
4521383938,36,3,0,4,6,2,1,0,1,0,15862,7.2,19244,229,60,-988,470,22.9,1586.2,17,2,1,6,4,6,1,1,0,0,16850,7.0,18774,232,56,988,-470,23.2,1685.0
4519754998,27,1,1,6,5,4,0,0,0,0,16789,7.0,19024,218,72,959,917,21.8,1678.9,17,3,0,5,6,5,1,1,0,0,15830,7.0,18107,213,52,-959,-917,21.3,1583.0
4424593685,15,2,0,3,3,4,0,0,0,0,14462,6.6,15785,197,47,-360,-1748,19.7,1446.2,23,1,1,3,3,2,1,0,1,0,14822,6.8,17533,209,56,360,1748,20.9,1482.2
4505255448,18,1,1,12,1,12,1,1,0,0,20136,7.8,20899,235,61,6290,4719,23.5,2013.6,13,0,0,1,12,0,0,0,0,0,13846,6.4,16180,201,63,-6290,-4719,20.1,1384.6
4432528181,16,0,1,8,5,11,0,0,0,0,17145,7.0,17795,204,70,2563,1726,20.4,1714.5,13,3,0,5,8,5,1,1,0,0,14582,6.6,16069,181,36,-2563,-1726,18.1,1458.2
4511747596,15,2,1,12,8,18,0,0,0,0,18238,6.8,16827,189,32,1797,-723,18.9,1823.8,18,4,0,8,12,5,1,1,0,0,16441,6.8,17550,190,47,-1797,723,19.0,1644.1
4517515942,22,4,1,10,9,8,1,1,0,0,17394,7.0,18046,195,28,-614,-846,19.5,1739.4,14,3,0,9,10,8,0,0,0,0,18008,7.0,18892,187,92,614,846,18.7,1800.8
4469572120,12,1,1,6,7,5,2,1,1,0,16683,7.0,18169,213,58,-73,333,21.3,1668.3,13,1,0,7,6,11,0,0,0,0,16756,6.8,17836,213,47,73,-333,21.3,1675.6
4503340964,16,5,1,7,10,4,0,0,0,0,16805,7.0,18285,229,55,-1785,-1131,22.9,1680.5,19,2,0,10,7,12,2,1,1,0,18590,7.4,19416,248,56,1785,1131,24.8,1859.0
4447643884,16,2,1,8,4,8,0,0,0,0,17531,6.8,18252,230,56,2236,288,23.0,1753.1,14,1,0,4,8,2,0,0,0,0,15295,6.8,17964,212,48,-2236,-288,21.2,1529.5
4526817312,16,1,1,4,3,5,0,0,0,0,16425,7.0,17611,227,44,2167,538,22.7,1642.5,16,1,0,3,4,4,1,1,0,0,14258,6.8,17073,208,46,-2167,-538,20.8,1425.8
4420481816,18,4,0,8,3,7,1,0,1,0,17574,7.2,19195,252,44,2774,2207,25.2,1757.4,15,4,1,3,8,2,1,1,0,0,14800,6.6,16988,225,47,-2774,-2207,22.5,1480.0
4520671984,16,6,1,12,6,25,1,1,0,0,19321,7.0,18437,226,42,2574,359,22.6,1932.1,15,2,0,6,12,9,0,0,0,0,16747,7.0,18078,228,56,-2574,-359,22.8,1674.7
4525161056,40,4,0,6,4,11,0,0,0,0,16814,7.0,18612,238,56,2247,1262,23.8,1681.4,14,2,1,4,6,0,1,1,0,0,14567,6.8,17350,220,55,-2247,-1262,22.0,1456.7
4524530613,15,3,0,4,12,3,0,0,0,0,16361,6.8,17937,225,68,-2902,-1196,22.5,1636.1,53,3,1,12,4,16,1,1,0,0,19263,7.2,19133,231,56,2902,1196,23.1,1926.3
4511927788,26,2,0,2,7,1,0,0,0,0,14918,6.8,17605,221,53,-2442,-1427,22.1,1491.8,17,2,1,7,2,10,1,1,0,0,17360,7.2,19032,262,48,2442,1427,26.2,1736.0
4467262571,12,0,0,7,9,4,1,0,1,0,17075,6.8,17991,218,54,-372,177,21.8,1707.5,45,2,1,9,7,11,0,0,0,0,17447,7.0,17814,217,36,372,-177,21.7,1744.7
4474906958,17,5,0,6,7,10,1,0,1,0,16027,6.6,16856,212,44,-177,-113,21.2,1602.7,16,5,1,7,6,8,1,1,0,0,16204,6.4,16969,183,48,177,113,18.3,1620.4
4517973417,15,5,1,7,1,10,1,1,0,0,16932,7.2,19942,235,55,2699,2575,23.5,1693.2,53,5,0,1,7,1,0,0,0,0,14233,6.8,17367,242,52,-2699,-2575,24.2,1423.3
4521058340,18,1,0,7,4,8,1,1,0,0,17137,7.0,18628,240,45,2191,2220,24.0,1713.7,16,2,1,4,7,7,0,0,0,0,14946,6.4,16408,203,43,-2191,-2220,20.3,1494.6
4518881897,16,1,1,7,6,5,0,0,0,0,16345,6.6,16530,204,47,-323,-992,20.4,1634.5,54,2,0,6,7,8,1,1,0,0,16668,7.0,17522,190,56,323,992,19.0,1666.8
4479878134,17,2,1,6,5,5,1,1,0,0,17170,7.0,18247,247,48,2453,1802,24.7,1717.0,17,3,0,5,6,4,0,0,0,0,14717,6.6,16445,178,40,-2453,-1802,17.8,1471.7
4478110348,14,5,1,3,4,2,0,0,0,0,14490,6.8,17534,226,37,-1759,-2019,22.6,1449.0,41,3,0,4,3,1,1,1,0,0,16249,7.2,19553,247,58,1759,2019,24.7,1624.9
4495708706,18,2,1,3,10,4,0,0,0,0,14557,6.4,15128,200,48,-3582,-5395,20.0,1455.7,16,0,0,10,3,10,2,1,1,0,18139,7.6,20523,246,63,3582,5395,24.6,1813.9
4297422468,18,2,0,4,6,0,0,0,0,0,14827,6.6,17370,207,55,-2713,-1237,20.7,1482.7,20,6,1,6,4,11,2,1,1,0,17540,7.2,18607,247,56,2713,1237,24.7,1754.0
4478190403,18,4,0,7,9,5,0,0,0,0,16709,7.2,19029,227,48,-629,180,22.7,1670.9,17,4,1,9,7,9,0,0,0,0,17338,7.2,18849,223,56,629,-180,22.3,1733.8
4522651290,14,4,0,2,4,1,0,0,0,0,14721,7.0,18073,234,51,-964,72,23.4,1472.1,19,0,1,4,2,4,1,1,0,0,15685,7.0,18001,238,48,964,-72,23.8,1568.5
4500406519,18,4,1,4,7,2,0,0,0,0,15950,6.8,17900,235,58,-365,-434,23.5,1595.0,16,2,0,7,4,7,0,0,0,0,16315,6.8,18334,225,37,365,434,22.5,1631.5
4470453534,14,3,1,5,8,5,0,0,0,0,16574,6.8,18040,231,48,-37,-382,23.1,1657.4,14,0,0,8,5,10,0,0,0,0,16611,7.0,18422,209,50,37,382,20.9,1661.1
4520495529,15,5,1,6,3,5,2,1,1,0,16929,7.4,19425,263,54,1101,1147,26.3,1692.9,80,4,0,3,6,3,0,0,0,0,15828,7.2,18278,242,49,-1101,-1147,24.2,1582.8
4522561277,16,1,1,3,2,1,0,0,0,0,15360,7.0,18355,220,55,960,39,22.0,1536.0,16,3,0,2,3,2,0,0,0,0,14400,6.8,18316,206,52,-960,-39,20.6,1440.0
4427804202,13,4,0,7,6,14,1,1,0,0,16304,6.2,15338,182,45,-61,-1738,18.2,1630.4,18,1,1,6,7,8,0,0,0,0,16365,6.4,17076,219,44,61,1738,21.9,1636.5
4524316009,14,2,0,5,7,2,1,0,1,0,15493,6.8,17405,211,52,-860,-121,21.1,1549.3,17,0,1,7,5,10,1,1,0,0,16353,7.0,17526,202,46,860,121,20.2,1635.3
4511485561,19,4,1,8,4,13,1,1,0,0,16712,6.8,17797,194,48,2357,1436,19.4,1671.2,54,3,0,4,8,3,0,0,0,0,14355,6.4,16361,162,52,-2357,-1436,16.2,1435.5
4500722833,25,3,1,6,1,9,1,1,0,0,17450,7.2,19276,233,44,3610,2295,23.3,1745.0,12,2,0,1,6,1,0,0,0,0,13840,6.4,16981,226,39,-3610,-2295,22.6,1384.0
4456743513,17,1,0,5,4,10,1,1,0,0,15976,6.8,17352,232,37,609,-609,23.2,1597.6,14,2,1,4,5,5,1,0,1,0,15367,7.0,17961,235,49,-609,609,23.5,1536.7
4484058077,35,3,1,6,6,8,1,1,0,0,16073,7.0,18021,196,52,-570,467,19.6,1607.3,146,3,0,6,6,10,0,0,0,0,16643,6.8,17554,215,46,570,-467,21.5,1664.3
4524969283,15,1,1,6,6,10,0,0,0,0,16260,6.8,17516,205,59,-402,-520,20.5,1626.0,18,2,0,6,6,7,1,0,1,0,16662,7.0,18036,219,51,402,520,21.9,1666.2
4521050859,21,2,0,3,4,1,0,0,0,0,14202,6.8,16773,212,37,-2263,-1397,21.2,1420.2,14,6,1,4,3,4,1,1,0,0,16465,6.8,18170,240,60,2263,1397,24.0,1646.5
4512485280,16,3,0,8,2,10,0,0,0,0,17917,7.0,17502,239,48,3201,276,23.9,1791.7,14,2,1,2,8,3,1,1,0,0,14716,6.8,17226,197,72,-3201,-276,19.7,1471.6
4524458385,16,7,1,5,5,5,0,0,0,0,15722,6.8,16349,222,34,679,471,22.2,1572.2,16,3,0,5,5,5,0,0,0,0,15043,6.4,15878,181,48,-679,-471,18.1,1504.3
4476138095,51,3,0,4,6,7,0,0,0,0,15766,6.8,16923,213,47,-856,-642,21.3,1576.6,16,3,1,6,4,6,1,1,0,0,16622,6.6,17565,239,58,856,642,23.9,1662.2
4503243020,17,2,0,3,12,3,0,0,0,0,14232,6.6,16592,216,38,-5617,-4035,21.6,1423.2,15,2,1,12,3,17,1,1,0,0,19849,7.6,20627,238,68,5617,4035,23.8,1984.9
4525339326,14,2,1,1,3,1,1,1,0,0,14832,7.0,17330,228,60,-196,-282,22.8,1483.2,18,2,0,3,1,4,0,0,0,0,15028,7.0,17612,226,48,196,282,22.6,1502.8
4510604428,14,3,1,1,8,1,0,0,0,0,14742,6.8,16872,219,51,-2177,-2726,21.9,1474.2,13,2,0,8,1,15,2,1,1,0,16919,7.2,19598,197,61,2177,2726,19.7,1691.9
4513214208,42,3,0,7,8,10,0,0,0,0,16337,6.8,17367,197,47,-38,281,19.7,1633.7,15,4,1,8,7,4,1,1,0,0,16375,6.6,17086,192,43,38,-281,19.2,1637.5
4473758044,24,2,0,2,8,2,1,0,1,0,13853,6.2,14781,205,42,-3650,-3119,20.5,1385.3,17,4,1,8,2,7,0,0,0,0,17503,7.2,17900,221,46,3650,3119,22.1,1750.3
4525023717,15,1,1,6,5,4,0,0,0,0,16287,6.6,17787,226,52,25,2,22.6,1628.7,13,2,0,5,6,9,0,0,0,0,16262,6.8,17785,226,45,-25,-2,22.6,1626.2
4521293628,13,6,0,10,11,13,1,1,0,0,17948,6.6,16194,193,35,93,-1276,19.3,1794.8,17,3,1,11,10,13,0,0,0,0,17855,6.8,17470,219,40,-93,1276,21.9,1785.5
4502515468,23,2,1,12,5,13,0,0,0,0,17307,6.4,16818,189,26,3237,2107,18.9,1730.7,14,0,0,5,12,4,0,0,0,0,14070,6.2,14711,158,33,-3237,-2107,15.8,1407.0
4524250490,16,3,0,6,4,1,0,0,0,0,16327,7.0,18521,190,59,1570,1320,19.0,1632.7,16,1,1,4,6,1,1,1,0,0,14757,6.8,17201,214,56,-1570,-1320,21.4,1475.7
4519375393,13,3,0,7,4,5,0,0,0,0,16650,7.0,18854,233,48,-612,549,23.3,1665.0,19,1,1,4,7,5,2,1,1,1,17262,7.0,18305,232,59,612,-549,23.2,1726.2
4508198441,18,3,0,2,9,4,0,0,0,0,14691,6.8,17573,207,67,-4024,-1999,20.7,1469.1,13,3,1,9,2,18,1,1,0,0,18715,7.4,19572,242,55,4024,1999,24.2,1871.5
4522209032,15,4,0,4,4,2,1,1,0,0,14697,7.0,17818,222,48,-1620,-1655,22.2,1469.7,16,1,1,4,4,4,0,0,0,0,16317,7.4,19473,255,72,1620,1655,25.5,1631.7
4477952218,18,5,1,2,3,1,0,0,0,0,15219,6.8,17357,241,48,-563,-1422,24.1,1521.9,19,5,0,3,2,3,1,1,0,0,15782,7.0,18779,225,68,563,1422,22.5,1578.2
4489200768,20,4,1,7,5,7,0,0,0,0,17622,7.2,18672,247,50,2077,986,24.7,1762.2,16,5,0,5,7,5,1,1,0,0,15545,6.8,17686,226,47,-2077,-986,22.6,1554.5
4512490031,13,1,0,3,4,3,1,1,0,0,14943,6.8,17710,223,51,-626,61,22.3,1494.3,18,1,1,4,3,8,0,0,0,0,15569,6.8,17649,233,48,626,-61,23.3,1556.9
4526741895,13,4,1,6,8,7,0,0,0,0,17190,6.8,17552,226,44,777,576,22.6,1719.0,17,1,0,8,6,9,0,0,0,0,16413,6.6,16976,190,30,-777,-576,19.0,1641.3
4447643758,17,3,0,1,1,2,0,0,0,0,14649,7.0,17790,229,55,-444,-877,22.9,1464.9,19,4,1,1,1,1,1,0,1,0,15093,7.0,18667,247,55,444,877,24.7,1509.3
4513611157,18,4,0,11,6,13,0,0,0,0,18748,7.0,19116,243,40,2520,2092,24.3,1874.8,53,4,1,6,11,5,0,0,0,0,16228,6.8,17024,224,40,-2520,-2092,22.4,1622.8
4522503290,16,3,1,7,13,9,0,0,0,0,17372,6.8,17530,202,56,-2817,-1700,20.2,1737.2,21,1,0,13,7,17,1,1,0,0,20189,7.2,19230,218,58,2817,1700,21.8,2018.9
4517836453,12,5,1,3,7,3,0,0,0,0,15159,6.6,17052,235,60,-1984,-1530,23.5,1515.9,18,2,0,7,3,16,1,1,0,0,17143,6.8,18582,238,47,1984,1530,23.8,1714.3
4523726698,20,22,0,3,11,7,0,0,0,0,13511,5.8,14048,164,39,-5427,-4559,16.4,1351.1,40,3,1,11,3,14,1,1,0,0,18938,7.2,18607,239,57,5427,4559,23.9,1893.8
4494291164,17,1,0,6,4,7,0,0,0,0,16091,7.0,18518,238,38,356,122,23.8,1609.1,14,4,1,4,6,4,1,1,0,0,15735,7.0,18396,217,64,-356,-122,21.7,1573.5
4522255964,15,1,0,6,7,5,1,0,1,0,16461,7.0,18295,173,64,-667,1243,17.3,1646.1,17,3,1,7,6,9,0,0,0,0,17128,6.6,17052,224,39,667,-1243,22.4,1712.8
4465934197,16,4,1,6,3,7,0,0,0,0,16434,6.8,18132,216,77,1545,1824,21.6,1643.4,19,2,0,3,6,3,1,1,0,0,14889,6.4,16308,233,40,-1545,-1824,23.3,1488.9
4526597273,89,2,1,11,7,14,0,0,0,0,19866,7.6,20339,202,53,3128,2919,20.2,1986.6,15,2,0,7,11,5,0,0,0,0,16738,6.8,17420,202,48,-3128,-2919,20.2,1673.8
4517803168,20,3,1,13,6,12,0,0,0,0,19012,7.2,18944,210,54,2194,1814,21.0,1901.2,19,2,0,6,13,9,0,0,0,0,16818,6.8,17130,195,49,-2194,-1814,19.5,1681.8
4434732074,19,3,0,2,6,1,1,1,0,0,14107,6.6,17015,180,72,-1699,-364,18.0,1410.7,20,3,1,6,2,10,0,0,0,0,15806,6.8,17379,220,40,1699,364,22.0,1580.6
4516995373,38,4,1,2,3,5,1,0,1,0,14992,6.8,18110,226,56,-415,1224,22.6,1499.2,20,2,0,3,2,5,1,1,0,0,15407,6.6,16886,222,55,415,-1224,22.2,1540.7
4513352439,20,5,1,4,5,3,0,0,0,0,16083,6.8,18268,264,53,80,-609,26.4,1608.3,67,2,0,5,4,8,1,1,0,0,16003,7.2,18877,225,53,-80,609,22.5,1600.3
4516268505,42,2,1,8,3,6,0,0,0,0,16532,7.2,18420,229,40,1558,785,22.9,1653.2,34,2,0,3,8,2,1,0,1,0,14974,7.0,17635,206,56,-1558,-785,20.6,1497.4
4523270245,15,0,1,3,2,4,0,0,0,0,15719,7.4,19029,230,60,753,263,23.0,1571.9,13,0,0,2,3,3,1,1,0,0,14966,7.2,18766,236,63,-753,-263,23.6,1496.6
4523917327,15,2,0,16,10,17,2,1,1,0,20344,7.0,18646,193,48,3175,1975,19.3,2034.4,43,1,1,10,16,11,0,0,0,0,17169,6.6,16671,162,32,-3175,-1975,16.2,1716.9
4445378393,16,4,0,10,5,8,1,0,1,0,19169,7.4,19642,235,48,3305,2586,23.5,1916.9,17,1,1,5,10,6,1,1,0,0,15864,7.0,17056,215,44,-3305,-2586,21.5,1586.4
4504366745,24,3,0,6,5,8,0,0,0,0,16809,7.4,19023,225,68,226,557,22.5,1680.9,52,4,1,5,6,7,2,1,1,0,16583,7.2,18466,239,64,-226,-557,23.9,1658.3
4523550797,12,4,0,2,6,2,0,0,0,0,14944,6.8,17906,237,45,-2150,-1318,23.7,1494.4,22,3,1,6,2,11,1,1,0,0,17094,7.2,19224,241,76,2150,1318,24.1,1709.4
4501451685,14,4,0,5,8,7,2,1,1,0,16256,7.0,17637,231,56,-1623,-1144,23.1,1625.6,14,0,1,8,5,9,0,0,0,0,17879,7.0,18781,243,48,1623,1144,24.3,1787.9
4413462978,18,2,1,5,2,6,1,1,0,0,15814,7.0,17846,240,52,1012,191,24.0,1581.4,34,2,0,2,5,1,0,0,0,0,14802,6.8,17655,229,51,-1012,-191,22.9,1480.2
4520730804,21,6,1,3,1,2,2,1,1,0,15530,6.8,17715,235,52,1219,232,23.5,1553.0,42,4,0,1,3,3,0,0,0,0,14311,6.8,17483,238,46,-1219,-232,23.8,1431.1
4524400852,15,3,1,14,8,14,2,1,1,1,21927,7.4,20604,250,57,5263,3213,25.0,2192.7,22,3,0,8,14,11,0,0,0,0,16664,7.0,17391,174,51,-5263,-3213,17.4,1666.4
4454104215,14,2,0,9,8,10,1,1,0,0,17530,7.0,18299,192,43,-7,-231,19.2,1753.0,19,2,1,8,9,8,1,0,1,0,17537,7.2,18530,209,60,7,231,20.9,1753.7
4508028772,13,2,0,6,5,4,1,1,0,0,15655,6.8,17386,203,53,-693,-919,20.3,1565.5,14,1,1,5,6,5,0,0,0,0,16348,7.0,18305,234,56,693,919,23.4,1634.8
4525204773,18,5,1,6,5,8,1,1,0,0,16660,6.8,17964,241,44,850,-98,24.1,1666.0,14,5,0,5,6,4,0,0,0,0,15810,7.0,18062,215,39,-850,98,21.5,1581.0
4515443406,18,3,0,10,7,12,0,0,0,0,18996,7.2,18231,231,47,3227,1158,23.1,1899.6,19,5,1,7,10,5,1,1,0,0,15769,6.6,17073,175,52,-3227,-1158,17.5,1576.9
4525345831,17,0,1,7,6,4,0,0,0,0,16466,6.8,16798,185,52,59,-305,18.5,1646.6,12,4,0,6,7,10,2,1,1,0,16407,7.0,17103,210,53,-59,305,21.0,1640.7
4477006616,14,1,1,4,5,5,0,0,0,0,16193,7.0,18763,235,64,-405,-1523,23.5,1619.3,18,3,0,5,4,7,2,1,1,0,16598,7.4,20286,248,65,405,1523,24.8,1659.8
4520983823,18,5,0,3,8,3,0,0,0,0,14790,6.4,16619,217,37,-1967,-1292,21.7,1479.0,19,2,1,8,3,11,1,1,0,0,16757,7.0,17911,204,52,1967,1292,20.4,1675.7
4468732592,16,5,1,7,4,10,0,0,0,0,18342,7.4,20325,224,75,2587,2759,22.4,1834.2,164,2,0,4,7,3,1,1,0,0,15755,6.6,17566,213,54,-2587,-2759,21.3,1575.5
4486617771,14,0,0,4,6,5,0,0,0,0,15908,7.0,18133,218,68,-1345,169,21.8,1590.8,48,1,1,6,4,9,1,1,0,0,17253,6.8,17964,220,68,1345,-169,22.0,1725.3
4523664992,42,5,1,10,5,11,0,0,0,0,19636,7.2,19567,247,55,4253,2731,24.7,1963.6,18,2,0,5,10,6,2,1,1,0,15383,6.6,16836,209,56,-4253,-2731,20.9,1538.3
4484154962,18,3,1,8,10,7,0,0,0,0,16180,6.6,16639,185,36,-2807,-2956,18.5,1618.0,16,3,0,10,8,17,0,0,0,0,18987,7.4,19595,236,61,2807,2956,23.6,1898.7
4483298051,19,3,0,7,3,5,0,0,0,0,17235,7.4,19915,257,57,2648,2595,25.7,1723.5,14,6,1,3,7,3,0,0,0,0,14587,6.8,17320,191,52,-2648,-2595,19.1,1458.7
4475955014,18,1,0,8,5,8,1,1,0,0,16469,7.0,18105,192,46,248,582,19.2,1646.9,15,2,1,5,8,10,0,0,0,0,16221,6.6,17523,225,52,-248,-582,22.5,1622.1
4518437302,14,2,0,3,7,3,0,0,0,0,14501,6.6,16545,195,64,-2930,-2779,19.5,1450.1,17,5,1,7,3,5,1,1,0,0,17431,7.2,19324,239,60,2930,2779,23.9,1743.1
4518871878,18,2,1,6,6,9,0,0,0,0,16450,7.0,17518,212,61,-577,-1953,21.2,1645.0,14,3,0,6,6,5,2,1,1,0,17027,7.2,19471,239,55,577,1953,23.9,1702.7
4489607487,16,2,0,3,6,3,0,0,0,0,15092,7.0,18501,204,70,-1857,-699,20.4,1509.2,19,2,1,6,3,6,2,1,1,0,16949,7.2,19200,252,53,1857,699,25.2,1694.9
4509513084,15,3,1,7,6,7,1,1,0,0,17120,7.0,18447,205,55,860,284,20.5,1712.0,16,2,0,6,7,8,0,0,0,0,16260,7.2,18163,200,48,-860,-284,20.0,1626.0
4516722172,15,2,1,7,3,7,2,1,1,0,16467,6.8,17952,209,48,1418,129,20.9,1646.7,31,1,0,3,7,2,0,0,0,0,15049,6.8,17823,231,56,-1418,-129,23.1,1504.9
4499336930,16,3,1,5,8,6,0,0,0,0,16979,7.2,19193,247,56,-988,-797,24.7,1697.9,12,1,0,8,5,6,1,1,0,0,17967,7.4,19990,219,63,988,797,21.9,1796.7
4520766314,16,4,1,9,3,13,1,1,0,0,17941,7.2,18842,205,52,2361,770,20.5,1794.1,17,2,0,3,9,3,0,0,0,0,15580,6.8,18072,249,52,-2361,-770,24.9,1558.0
4468929593,14,2,1,3,7,4,1,1,0,0,15315,6.8,17144,210,50,-2478,-2136,21.0,1531.5,15,2,0,7,3,7,0,0,0,0,17793,7.2,19280,231,60,2478,2136,23.1,1779.3
4526844816,12,3,0,4,6,2,1,0,1,0,14372,6.8,16842,205,40,-1864,-2124,20.5,1437.2,19,4,1,6,4,3,0,0,0,0,16236,7.2,18966,216,54,1864,2124,21.6,1623.6
4526361954,24,0,1,8,2,9,1,1,0,1,17422,6.8,17192,211,24,2394,-1292,21.1,1742.2,36,5,0,2,8,3,0,0,0,0,15028,7.0,18484,210,76,-2394,1292,21.0,1502.8
4499945956,12,6,1,5,8,4,0,0,0,0,16116,6.8,16953,233,43,-89,-953,23.3,1611.6,16,2,0,8,5,3,1,1,0,0,16205,6.8,17906,213,52,89,953,21.3,1620.5
4510758423,16,4,1,6,1,4,0,0,0,0,17007,7.4,19713,242,52,3332,2410,24.2,1700.7,16,2,0,1,6,2,1,1,0,0,13675,6.8,17303,194,68,-3332,-2410,19.4,1367.5
4489770592,17,3,0,6,9,4,0,0,0,0,15136,7.0,18082,170,67,-3212,-786,17.0,1513.6,81,6,1,9,6,9,1,1,0,0,18348,7.0,18868,227,52,3212,786,22.7,1834.8
4509091721,42,4,1,9,10,15,0,0,0,0,18483,7.0,18474,222,44,270,-688,22.2,1848.3,19,4,0,10,9,13,1,1,0,0,18213,7.2,19162,207,68,-270,688,20.7,1821.3
4494781192,16,3,0,9,7,13,2,1,1,0,17906,6.8,18001,178,60,510,142,17.8,1790.6,14,1,1,7,9,4,0,0,0,0,17396,6.8,17859,215,56,-510,-142,21.5,1739.6
4519862589,16,2,1,10,6,12,1,0,1,0,18692,7.4,19767,248,48,2830,1589,24.8,1869.2,12,2,0,6,10,4,0,0,0,0,15862,6.8,18178,210,39,-2830,-1589,21.0,1586.2
4512915759,16,4,0,1,5,2,0,0,0,0,13286,6.2,15085,187,48,-4179,-3823,18.7,1328.6,20,4,1,5,1,4,1,1,0,0,17465,7.0,18908,236,67,4179,3823,23.6,1746.5
4517823981,14,2,1,4,7,4,0,0,0,0,14663,6.6,16512,242,16,-2405,-2654,24.2,1466.3,13,4,0,7,4,5,1,1,0,0,17068,7.2,19166,235,64,2405,2654,23.5,1706.8
4527478355,21,1,0,11,8,17,1,0,1,1,20109,7.2,18733,211,51,2700,1463,21.1,2010.9,15,2,1,8,11,9,0,0,0,0,17409,6.8,17270,231,40,-2700,-1463,23.1,1740.9
4486065632,40,1,0,6,6,6,0,0,0,0,15863,6.8,17012,221,29,46,881,22.1,1586.3,44,2,1,6,6,9,0,0,0,0,15817,6.4,16131,191,46,-46,-881,19.1,1581.7
4518395320,18,6,0,8,9,11,1,0,1,0,17147,6.8,17510,194,48,-1546,-1047,19.4,1714.7,18,6,1,9,8,12,1,1,0,0,18693,6.8,18557,244,55,1546,1047,24.4,1869.3
4447674252,11,2,0,2,9,2,0,0,0,0,13785,6.4,15847,195,44,-6199,-4997,19.5,1378.5,30,3,1,9,2,6,1,0,1,2,19984,7.6,20844,249,57,6199,4997,24.9,1998.4
4458668503,15,2,1,2,7,2,0,0,0,0,14270,6.4,15513,215,39,-3519,-4275,21.5,1427.0,14,3,0,7,2,8,1,1,0,0,17789,7.4,19788,241,56,3519,4275,24.1,1778.9
4450278971,21,5,1,7,6,6,2,1,1,0,17088,7.2,19719,220,55,1358,641,22.0,1708.8,16,4,0,6,7,4,0,0,0,0,15730,7.2,19078,211,50,-1358,-641,21.1,1573.0
4468657792,13,4,1,1,1,2,2,1,1,0,14546,7.0,17721,232,60,305,-443,23.2,1454.6,18,2,0,1,1,1,0,0,0,0,14241,7.2,18164,203,68,-305,443,20.3,1424.1
4515575207,18,1,1,13,2,11,1,1,0,0,19867,7.0,19401,236,58,6977,5303,23.6,1986.7,13,1,0,2,13,4,0,0,0,0,12890,5.8,14098,168,33,-6977,-5303,16.8,1289.0
4525089240,20,1,0,4,9,3,0,0,0,0,14695,6.8,18090,207,36,-2467,80,20.7,1469.5,77,6,1,9,4,10,1,1,0,0,17162,7.2,18010,187,56,2467,-80,18.7,1716.2
4505103694,70,2,0,10,5,11,2,1,1,0,18526,7.4,19693,222,65,1924,1992,22.2,1852.6,11,2,1,5,10,7,0,0,0,0,16602,7.0,17701,240,42,-1924,-1992,24.0,1660.2
4522686444,16,1,1,6,5,4,0,0,0,0,16682,7.0,18272,236,52,598,374,23.6,1668.2,14,4,0,5,6,5,1,1,0,0,16084,6.8,17898,235,60,-598,-374,23.5,1608.4
4448404997,15,3,0,5,8,5,0,0,0,0,16550,6.8,17563,204,60,-748,-1865,20.4,1655.0,40,1,1,8,5,9,1,0,1,0,17298,7.2,19428,227,48,748,1865,22.7,1729.8
4513642822,14,7,0,5,7,13,2,1,1,0,16829,7.0,19002,251,64,-1212,972,25.1,1682.9,15,2,1,7,5,10,0,0,0,0,18041,7.0,18030,236,48,1212,-972,23.6,1804.1
4500429958,15,1,1,7,7,8,1,1,0,0,16812,6.8,17939,226,52,-260,-369,22.6,1681.2,51,2,0,7,7,7,0,0,0,0,17072,7.2,18308,233,53,260,369,23.3,1707.2
4458431377,15,2,1,11,3,4,0,0,0,0,18192,7.2,19823,221,50,2639,1711,22.1,1819.2,13,1,0,3,11,2,0,0,0,0,15553,7.0,18112,230,49,-2639,-1711,23.0,1555.3
4473134497,18,1,0,3,11,4,0,0,0,0,14268,6.4,15723,213,42,-4962,-2384,21.3,1426.8,16,1,1,11,3,14,0,0,0,0,19230,7.0,18107,216,56,4962,2384,21.6,1923.0
4525356677,52,4,1,5,2,9,1,0,1,0,15574,6.8,16955,206,44,506,-142,20.6,1557.4,17,6,0,2,5,2,1,1,0,0,15068,6.6,17097,229,52,-506,142,22.9,1506.8
4445163609,18,6,1,8,5,6,1,0,1,0,17142,7.0,18245,221,38,2301,2562,22.1,1714.2,16,1,0,5,8,8,1,1,0,0,14841,6.4,15683,177,50,-2301,-2562,17.7,1484.1
4527285889,12,3,0,2,8,3,0,0,0,0,13337,6.0,14550,158,44,-5735,-5547,15.8,1333.7,94,2,1,8,2,6,2,1,1,1,19072,7.6,20097,232,68,5735,5547,23.2,1907.2
4489894297,20,5,0,6,2,4,1,0,1,0,17528,7.2,20077,257,64,2605,2260,25.7,1752.8,16,4,1,2,6,3,1,1,0,0,14923,6.8,17817,254,51,-2605,-2260,25.4,1492.3
4501257883,17,4,1,5,3,9,0,0,0,0,16725,7.0,18674,228,66,1279,384,22.8,1672.5,19,2,0,3,5,1,1,1,0,0,15446,7.0,18290,251,52,-1279,-384,25.1,1544.6
4518410386,38,1,0,2,8,1,0,0,0,0,14141,6.6,16555,211,37,-2749,-800,21.1,1414.1,24,0,1,8,2,14,0,0,0,0,16890,6.8,17355,206,44,2749,800,20.6,1689.0
4496483368,48,3,1,4,3,3,2,1,1,0,15656,7.0,17844,227,48,85,-706,22.7,1565.6,18,3,0,3,4,3,0,0,0,0,15571,7.0,18550,217,63,-85,706,21.7,1557.1
4519053131,17,2,1,13,5,16,0,0,0,0,19336,7.2,19116,212,30,4627,4784,21.2,1933.6,14,3,0,5,13,6,0,0,0,0,14709,6.0,14332,175,29,-4627,-4784,17.5,1470.9
4460534353,16,0,0,11,6,11,2,1,1,0,19294,7.4,20668,242,52,2750,2647,24.2,1929.4,14,2,1,6,11,9,0,0,0,0,16544,7.0,18021,203,52,-2750,-2647,20.3,1654.4
4526009569,37,2,0,1,9,3,0,0,0,0,13719,6.4,16024,202,43,-4492,-4085,20.2,1371.9,16,3,1,9,1,8,0,0,0,0,18211,7.6,20109,219,75,4492,4085,21.9,1821.1
4450881054,16,4,1,8,3,9,1,1,0,0,17636,7.4,19295,249,51,2578,1160,24.9,1763.6,15,1,0,3,8,1,1,0,1,0,15058,7.0,18135,232,56,-2578,-1160,23.2,1505.8
4522580950,41,13,1,2,4,3,1,0,1,0,15180,7.0,18148,225,68,-986,-1508,22.5,1518.0,40,1,0,4,2,3,1,1,0,0,16166,7.6,19656,235,76,986,1508,23.5,1616.6
4472428830,52,19,0,3,8,4,0,0,0,0,13636,6.2,14432,177,35,-4529,-4665,17.7,1363.6,37,2,1,8,3,7,2,1,1,0,18165,7.4,19097,249,60,4529,4665,24.9,1816.5
4511197912,43,2,1,12,7,13,0,0,0,0,18278,6.8,17024,191,24,2352,707,19.1,1827.8,17,5,0,7,12,9,0,0,0,0,15926,6.6,16317,189,45,-2352,-707,18.9,1592.6
4500339262,12,2,1,7,4,7,1,0,1,0,18821,7.2,19339,259,68,4074,2842,25.9,1882.1,13,1,0,4,7,6,0,0,0,0,14747,6.4,16497,189,36,-4074,-2842,18.9,1474.7
4438165073,17,3,1,5,9,5,1,1,0,0,15921,6.8,17353,210,68,-1490,-1624,21.0,1592.1,16,4,0,9,5,14,0,0,0,0,17411,7.2,18977,215,52,1490,1624,21.5,1741.1
4489954000,14,3,0,3,4,5,1,1,0,0,15565,6.8,17390,227,60,350,-664,22.7,1556.5,16,2,1,4,3,4,1,0,1,0,15215,7.0,18054,221,52,-350,664,22.1,1521.5
4468741090,17,8,1,10,5,17,1,1,0,0,19190,7.2,18615,202,34,3386,2410,20.2,1919.0,18,3,0,5,10,8,1,0,1,0,15804,6.4,16205,224,48,-3386,-2410,22.4,1580.4
4511683364,19,5,0,4,3,3,0,0,0,0,15832,7.2,18431,257,52,755,436,25.7,1583.2,17,4,1,3,4,4,2,1,1,0,15077,7.0,17995,217,60,-755,-436,21.7,1507.7
4522504958,15,4,0,6,8,7,1,1,0,0,16000,6.4,16023,212,19,-1208,-2526,21.2,1600.0,17,2,1,8,6,13,0,0,0,0,17208,7.2,18549,210,37,1208,2526,21.0,1720.8
4526718003,13,1,0,3,9,3,1,1,0,0,15431,6.8,17257,237,48,-2844,-2533,23.7,1543.1,36,2,1,9,3,11,0,0,0,0,18275,7.2,19790,221,44,2844,2533,22.1,1827.5
4519205202,18,2,0,5,6,7,0,0,0,0,16003,6.6,17152,213,55,-954,-1007,21.3,1600.3,18,4,1,6,5,14,1,1,0,0,16957,7.0,18159,261,49,954,1007,26.1,1695.7
4523788727,13,1,1,12,9,18,0,0,0,0,18748,6.8,17354,195,45,1212,77,19.5,1874.8,13,1,0,9,12,8,1,1,0,0,17536,7.0,17277,193,52,-1212,-77,19.3,1753.6
4515454034,16,3,0,4,14,4,0,0,0,0,15001,6.6,16275,205,37,-5120,-4011,20.5,1500.1,46,3,1,14,4,16,1,0,1,0,20121,7.4,20286,233,64,5120,4011,23.3,2012.1
4462971469,17,4,1,8,5,8,1,1,0,0,17610,7.4,18827,221,55,1677,809,22.1,1761.0,15,3,0,5,8,5,0,0,0,0,15933,7.2,18018,212,64,-1677,-809,21.2,1593.3
4526746921,14,3,0,6,9,9,1,1,0,0,15738,6.6,16512,188,53,-2550,-1985,18.8,1573.8,15,1,1,9,6,6,0,0,0,0,18288,7.0,18497,224,57,2550,1985,22.4,1828.8
4470414312,18,4,1,1,1,1,1,1,0,0,14529,7.0,17655,241,58,924,1282,24.1,1452.9,18,3,0,1,1,0,1,0,1,0,13605,6.4,16373,215,42,-924,-1282,21.5,1360.5
4523747667,14,1,0,6,6,6,0,0,0,0,17077,7.0,19128,242,61,-162,177,24.2,1707.7,15,2,1,6,6,9,0,0,0,0,17239,7.0,18951,245,66,162,-177,24.5,1723.9
4498058442,38,2,1,3,5,2,0,0,0,0,14452,6.4,15418,186,49,-1404,-2296,18.6,1445.2,18,2,0,5,3,3,1,1,0,0,15856,6.8,17714,228,56,1404,2296,22.8,1585.6
4518609876,16,2,0,4,3,2,1,1,0,0,15654,7.2,18324,233,46,-360,-61,23.3,1565.4,10,1,1,3,4,2,1,0,1,0,16014,7.0,18385,254,64,360,61,25.4,1601.4
4497898410,44,3,0,2,12,3,0,0,0,0,13899,6.4,15844,195,38,-6134,-6414,19.5,1389.9,24,6,1,12,2,9,1,1,0,0,20033,8.2,22258,236,83,6134,6414,23.6,2003.3
4410060427,17,4,1,5,5,5,1,0,1,0,16574,7.2,19529,235,60,803,857,23.5,1657.4,18,4,0,5,5,6,1,1,0,0,15771,7.2,18672,204,64,-803,-857,20.4,1577.1
4493030469,13,1,0,8,6,8,0,0,0,0,17251,6.6,17267,192,63,339,876,19.2,1725.1,16,0,1,6,8,7,0,0,0,0,16912,6.4,16391,203,48,-339,-876,20.3,1691.2
4520959679,16,4,1,8,8,9,0,0,0,0,17951,6.8,18517,219,56,680,-704,21.9,1795.1,54,9,0,8,8,9,1,1,0,0,17271,7.2,19221,216,68,-680,704,21.6,1727.1
4522545696,16,2,1,12,4,15,1,0,1,0,19000,7.0,18072,210,48,4181,1584,21.0,1900.0,15,2,0,4,12,4,0,0,0,0,14819,6.4,16488,193,45,-4181,-1584,19.3,1481.9
4520501584,15,2,1,6,4,6,1,1,0,0,16385,6.6,16580,208,45,1163,-1176,20.8,1638.5,14,0,0,4,6,4,1,0,1,0,15222,6.8,17756,194,52,-1163,1176,19.4,1522.2
4448127170,34,7,1,2,3,3,1,0,1,0,15345,7.2,18848,230,64,-164,1358,23.0,1534.5,19,3,0,3,2,7,1,1,0,0,15509,6.6,17490,236,55,164,-1358,23.6,1550.9
4470281902,17,1,1,8,6,11,0,0,0,0,17791,7.0,18244,216,48,1625,552,21.6,1779.1,16,2,0,6,8,9,1,1,0,0,16166,6.8,17692,215,48,-1625,-552,21.5,1616.6
4487454478,15,1,1,10,4,11,0,0,0,0,18314,7.0,17903,219,31,3884,2224,21.9,1831.4,11,0,0,4,10,6,1,1,0,0,14430,6.6,15679,167,48,-3884,-2224,16.7,1443.0
4508364030,17,0,1,8,10,7,0,0,0,0,16427,6.8,17468,191,43,-3441,-1876,19.1,1642.7,10,4,0,10,8,15,0,0,0,0,19868,7.2,19344,259,40,3441,1876,25.9,1986.8
4502224154,16,1,0,4,3,5,1,0,1,0,15804,7.2,18509,228,68,606,820,22.8,1580.4,11,0,1,3,4,5,1,1,0,0,15198,6.8,17689,210,60,-606,-820,21.0,1519.8
4396684519,16,3,0,8,6,13,1,1,0,0,17003,6.8,17843,222,43,253,-1300,22.2,1700.3,18,3,1,6,8,7,0,0,0,0,16750,7.2,19143,218,75,-253,1300,21.8,1675.0
4456745249,26,3,0,1,8,1,1,0,1,0,14044,6.8,16385,231,44,-4107,-3090,23.1,1404.4,20,6,1,8,1,12,1,1,0,0,18151,7.4,19475,234,60,4107,3090,23.4,1815.1
4505637581,13,0,1,4,4,4,1,1,0,0,15360,6.8,17742,228,44,97,-1064,22.8,1536.0,14,1,0,4,4,0,0,0,0,0,15263,7.0,18806,220,59,-97,1064,22.0,1526.3
4525336028,15,3,1,2,6,2,1,1,0,0,14967,6.8,16756,221,54,-1513,-2959,22.1,1496.7,12,2,0,6,2,7,0,0,0,0,16480,7.2,19715,224,62,1513,2959,22.4,1648.0
4520989053,85,2,1,5,9,2,1,0,1,0,16235,7.2,18790,213,67,-1126,-601,21.3,1623.5,20,2,0,9,5,6,1,1,0,0,17361,7.2,19391,230,44,1126,601,23.0,1736.1
4487639972,21,3,1,12,1,14,1,1,0,0,18923,7.0,18586,236,44,5323,2352,23.6,1892.3,52,4,0,1,12,1,0,0,0,0,13600,6.4,16234,191,56,-5323,-2352,19.1,1360.0
4522478777,25,1,1,13,5,15,0,0,0,0,19475,7.0,18495,218,37,4519,2852,21.8,1947.5,11,1,0,5,13,3,0,0,0,0,14956,6.4,15643,189,32,-4519,-2852,18.9,1495.6
4524109040,15,2,1,4,1,4,2,1,1,0,16305,7.2,19758,253,64,1793,929,25.3,1630.5,15,2,0,1,4,1,0,0,0,0,14512,7.2,18829,204,76,-1793,-929,20.4,1451.2
4466248745,130,5,0,3,7,3,0,0,0,0,14649,6.8,17099,186,52,-2588,-884,18.6,1464.9,21,2,1,7,3,9,1,1,0,0,17237,7.0,17983,246,36,2588,884,24.6,1723.7
4448381986,18,3,0,7,7,10,0,0,0,0,16531,6.6,16364,202,44,-869,327,20.2,1653.1,29,2,1,7,7,9,1,1,0,1,17400,6.6,16037,219,48,869,-327,21.9,1740.0
4446200696,15,1,0,5,7,5,1,0,1,1,17618,7.2,19203,225,63,1000,346,22.5,1761.8,11,3,1,7,5,7,1,1,0,0,16618,7.0,18857,199,52,-1000,-346,19.9,1661.8
4492722693,13,1,1,8,5,8,0,0,0,0,17953,6.8,18196,218,59,3363,2997,21.8,1795.3,13,2,0,5,8,9,1,1,0,0,14590,6.4,15199,176,43,-3363,-2997,17.6,1459.0
4502492792,18,3,1,3,4,3,1,1,0,0,15575,6.6,16473,220,48,737,-691,22.0,1557.5,18,4,0,4,3,4,0,0,0,0,14838,6.6,17164,201,43,-737,691,20.1,1483.8
4489645082,44,7,0,8,5,9,0,0,0,0,17345,7.0,18111,183,41,1421,-792,18.3,1734.5,19,3,1,5,8,4,1,1,0,0,15924,7.0,18903,207,68,-1421,792,20.7,1592.4
4515607398,19,2,0,8,3,7,1,1,0,0,18003,7.4,20207,248,77,3034,1983,24.8,1800.3,15,4,1,3,8,2,0,0,0,0,14969,7.0,18224,211,52,-3034,-1983,21.1,1496.9
4507155035,14,3,0,3,4,3,0,0,0,0,15885,7.2,18620,252,60,-390,-52,25.2,1588.5,19,4,1,4,3,4,1,1,0,0,16275,7.2,18672,258,51,390,52,25.8,1627.5
4525539438,17,2,0,5,11,3,0,0,0,0,15645,6.8,16821,203,42,-2328,-1524,20.3,1564.5,18,3,1,11,5,13,1,1,0,0,17973,6.8,18345,209,40,2328,1524,20.9,1797.3
4519746020,17,2,0,3,15,2,1,0,1,0,15320,6.8,16625,176,56,-4348,-4019,17.6,1532.0,33,5,1,15,3,15,1,1,0,0,19668,7.6,20644,208,48,4348,4019,20.8,1966.8
4522843315,18,0,1,9,8,7,0,0,0,0,16908,6.8,17271,196,31,-363,-191,19.6,1690.8,40,2,0,8,9,9,1,1,0,0,17271,6.8,17462,187,68,363,191,18.7,1727.1
4491856529,91,3,1,7,9,7,1,1,0,0,16452,6.8,17156,191,43,-2343,-2076,19.1,1645.2,21,5,0,9,7,5,1,0,1,0,18795,7.2,19232,261,44,2343,2076,26.1,1879.5
4519613119,14,1,0,10,7,7,0,0,0,0,18923,7.4,20387,241,59,1219,1356,24.1,1892.3,15,1,1,7,10,8,1,1,0,0,17704,7.0,19031,207,70,-1219,-1356,20.7,1770.4
4525145899,33,1,0,1,9,0,0,0,0,0,13933,6.6,16583,194,51,-5490,-2476,19.4,1393.3,18,2,1,9,1,8,1,1,0,1,19423,7.2,19059,225,52,5490,2476,22.5,1942.3
4472468602,18,4,1,5,3,10,0,0,0,0,15496,6.6,16654,184,47,-157,-269,18.4,1549.6,17,3,0,3,5,4,1,1,0,0,15653,6.6,16923,229,55,157,269,22.9,1565.3
4520968733,61,3,0,5,7,5,0,0,0,0,16343,6.8,18250,233,52,77,239,23.3,1634.3,17,4,1,7,5,9,1,1,0,0,16266,6.8,18011,203,52,-77,-239,20.3,1626.6
4525945422,16,4,1,4,7,4,0,0,0,0,15613,6.6,18046,244,46,-1002,-498,24.4,1561.3,59,2,0,7,4,9,2,1,1,0,16615,7.0,18544,181,60,1002,498,18.1,1661.5
4467537493,17,2,0,3,8,3,0,0,0,0,13817,6.4,14829,167,44,-3294,-2723,16.7,1381.7,13,3,1,8,3,5,1,1,0,0,17111,6.6,17552,206,48,3294,2723,20.6,1711.1
4481977173,11,5,1,6,9,8,0,0,0,0,17025,7.0,18038,231,40,-1314,-1942,23.1,1702.5,17,2,0,9,6,9,1,1,0,0,18339,7.4,19980,232,57,1314,1942,23.2,1833.9
4477952822,19,1,0,4,2,4,0,0,0,0,15205,6.8,17501,234,44,457,690,23.4,1520.5,18,2,1,2,4,2,1,1,0,0,14748,6.6,16811,250,45,-457,-690,25.0,1474.8
4521347328,124,1,1,10,4,12,0,0,0,0,18509,7.6,20432,223,72,2974,1421,22.3,1850.9,15,1,0,4,10,5,1,1,0,0,15535,7.4,19011,213,64,-2974,-1421,21.3,1553.5
4502701964,15,10,1,6,5,3,1,0,1,0,17293,7.0,18795,231,60,1339,614,23.1,1729.3,48,4,0,5,6,6,1,1,0,0,15954,7.2,18181,236,48,-1339,-614,23.6,1595.4
4518146165,13,2,0,7,14,11,0,0,0,0,14416,5.2,11286,90,30,-5253,-5281,9.0,1441.6,16,1,1,14,7,19,0,0,0,0,19669,6.6,16567,203,44,5253,5281,20.3,1966.9
4455553618,81,0,0,4,4,4,1,1,0,0,15742,7.2,18562,244,52,-896,-1292,24.4,1574.2,14,2,1,4,4,4,0,0,0,0,16638,7.4,19854,252,72,896,1292,25.2,1663.8
4525939655,15,1,0,11,9,10,1,1,0,0,17480,6.6,17096,203,39,-366,-923,20.3,1748.0,17,1,1,9,11,10,0,0,0,0,17846,6.6,18019,217,60,366,923,21.7,1784.6
4475613752,16,2,0,10,9,7,2,1,1,0,17793,7.2,19322,215,59,508,1164,21.5,1779.3,15,1,1,9,10,10,0,0,0,0,17285,7.0,18158,193,56,-508,-1164,19.3,1728.5
4521937261,16,2,0,3,8,4,2,1,1,0,15209,6.6,16256,191,60,-2752,-2286,19.1,1520.9,17,4,1,8,3,9,0,0,0,0,17961,7.2,18542,241,52,2752,2286,24.1,1796.1
4508915149,14,1,0,0,5,0,0,0,0,0,13561,6.6,16518,220,51,-1958,-1775,22.0,1356.1,15,3,1,5,0,4,1,1,0,0,15519,7.0,18293,223,37,1958,1775,22.3,1551.9
4519799499,19,4,1,5,5,6,0,0,0,0,16780,7.0,19102,253,63,774,1187,25.3,1678.0,17,6,0,5,5,7,1,1,0,0,16006,7.0,17915,233,52,-774,-1187,23.3,1600.6
4511414132,13,3,1,5,5,7,0,0,0,0,15658,7.0,17569,224,45,-1047,-1618,22.4,1565.8,14,3,0,5,5,5,0,0,0,0,16705,7.2,19187,251,54,1047,1618,25.1,1670.5
4511940066,38,4,1,4,7,1,1,0,1,0,15198,6.8,17307,214,50,-2090,-2188,21.4,1519.8,17,3,0,7,4,7,1,1,0,0,17288,7.2,19495,222,71,2090,2188,22.2,1728.8
4514199075,18,2,1,4,6,4,0,0,0,0,16317,7.0,17928,228,50,-248,-1557,22.8,1631.7,20,3,0,6,4,4,2,1,1,0,16565,7.2,19485,225,59,248,1557,22.5,1656.5
4450965514,18,5,0,8,14,10,0,0,0,0,17157,6.6,17475,200,36,-2095,-2096,20.0,1715.7,18,4,1,14,8,15,0,0,0,0,19252,7.4,19571,206,44,2095,2096,20.6,1925.2
4464352676,17,3,0,7,10,7,1,0,1,0,16375,6.8,17469,177,51,-3183,-1884,17.7,1637.5,15,5,1,10,7,9,0,0,0,1,19558,7.2,19353,236,72,3183,1884,23.6,1955.8
4527355531,13,1,0,6,3,5,2,1,1,0,16807,7.2,19662,232,60,2052,2845,23.2,1680.7,75,1,1,3,6,1,0,0,0,0,14755,6.8,16817,216,48,-2052,-2845,21.6,1475.5
4523657411,18,1,0,6,4,4,0,0,0,0,16948,7.0,18271,252,60,2346,1424,25.2,1694.8,14,4,1,4,6,1,1,1,0,0,14602,6.4,16847,211,51,-2346,-1424,21.1,1460.2
4512583390,15,4,1,9,2,11,0,0,0,0,18442,7.4,19414,248,51,2680,1700,24.8,1844.2,19,3,0,2,9,1,2,1,1,0,15762,7.0,17714,240,52,-2680,-1700,24.0,1576.2
4465078328,27,2,0,5,4,6,0,0,0,0,15732,6.6,16582,218,44,17,-1014,21.8,1573.2,15,3,1,4,5,4,0,0,0,0,15715,7.0,17596,248,44,-17,1014,24.8,1571.5
4467316184,13,0,0,7,6,4,1,1,0,1,17742,7.0,18795,203,64,2294,2616,20.3,1774.2,13,1,1,6,7,6,0,0,0,0,15448,6.6,16179,186,40,-2294,-2616,18.6,1544.8
4521907618,13,3,0,6,8,8,1,0,1,1,18234,6.6,17526,205,59,1619,-575,20.5,1823.4,17,3,1,8,6,5,0,0,0,0,16615,7.0,18101,209,46,-1619,575,20.9,1661.5
4519724135,14,0,1,8,10,11,0,0,0,0,16052,6.4,15330,159,44,-1825,-1458,15.9,1605.2,18,1,0,10,8,14,1,1,0,0,17877,6.6,16788,213,41,1825,1458,21.3,1787.7
4523437781,18,2,0,3,10,4,1,1,0,0,14878,6.4,16786,213,47,-4657,-4000,21.3,1487.8,39,4,1,10,3,11,0,0,0,1,19535,7.6,20786,244,56,4657,4000,24.4,1953.5
4524104535,13,2,1,7,2,5,1,0,1,0,16242,7.0,17867,218,48,2156,2101,21.8,1624.2,17,0,0,2,7,3,0,0,0,0,14086,6.4,15766,212,38,-2156,-2101,21.2,1408.6
4486673822,15,3,0,4,7,5,0,0,0,0,15535,6.8,18068,214,56,-1608,-572,21.4,1553.5,16,1,1,7,4,9,2,1,1,0,17143,7.0,18640,220,59,1608,572,22.0,1714.3
4503065925,13,3,1,9,1,15,1,1,0,0,18053,6.8,18267,247,51,4135,1375,24.7,1805.3,28,0,0,1,9,2,0,0,0,0,13918,6.6,16892,211,59,-4135,-1375,21.1,1391.8
4461214115,12,1,1,6,8,5,0,0,0,0,16560,7.0,18074,203,65,-407,-1257,20.3,1656.0,47,2,0,8,6,7,1,1,0,0,16967,7.4,19331,223,52,407,1257,22.3,1696.7
4521867073,20,1,1,8,7,12,1,0,1,0,18339,7.4,19803,232,74,694,1305,23.2,1833.9,37,7,0,7,8,10,1,1,0,0,17645,7.4,18498,245,49,-694,-1305,24.5,1764.5
4496993021,12,4,0,4,4,1,0,0,0,0,15786,7.2,18637,246,60,987,1253,24.6,1578.6,17,1,1,4,4,4,1,1,0,0,14799,6.8,17384,200,47,-987,-1253,20.0,1479.9
4500080276,19,1,1,7,0,8,0,0,0,0,16688,7.2,19162,233,60,3060,2469,23.3,1668.8,32,0,0,0,7,0,1,1,0,0,13628,6.8,16693,222,57,-3060,-2469,22.2,1362.8
4515437338,16,5,1,9,3,10,2,1,1,0,18293,7.2,19981,240,59,3691,2805,24.0,1829.3,11,3,0,3,9,3,0,0,0,0,14602,7.0,17176,186,51,-3691,-2805,18.6,1460.2
4470712101,22,3,0,7,4,8,1,1,0,0,16413,6.8,16989,209,39,188,-1124,20.9,1641.3,83,6,1,4,7,6,0,0,0,0,16225,6.8,18113,248,47,-188,1124,24.8,1622.5
4508690422,18,2,0,11,5,11,0,0,0,0,18403,7.4,19486,239,48,2239,1539,23.9,1840.3,22,4,1,5,11,4,1,1,0,0,16164,6.6,17947,231,63,-2239,-1539,23.1,1616.4
4462027689,16,5,1,6,4,8,1,1,0,1,18395,7.0,19241,236,52,3354,2318,23.6,1839.5,37,3,0,4,6,6,0,0,0,0,15041,6.8,16923,185,52,-3354,-2318,18.5,1504.1
4512191595,37,3,1,6,8,4,2,1,1,0,16168,6.8,17184,204,36,-1003,-491,20.4,1616.8,21,1,0,8,6,7,0,0,0,0,17171,6.8,17675,220,59,1003,491,22.0,1717.1
4512089912,22,2,1,5,6,4,0,0,0,0,15218,6.4,16539,211,48,-828,421,21.1,1521.8,14,4,0,6,5,10,0,0,0,0,16046,6.6,16118,206,34,828,-421,20.6,1604.6
4483692276,15,2,1,6,5,7,1,0,1,0,17674,7.2,19752,225,80,2521,3096,22.5,1767.4,56,1,0,5,6,8,0,0,0,0,15153,6.6,16656,217,36,-2521,-3096,21.7,1515.3
4519857386,17,4,1,5,4,4,0,0,0,0,17431,7.2,18675,272,46,300,427,27.2,1743.1,17,2,0,4,5,3,2,1,1,1,17131,7.0,18248,236,56,-300,-427,23.6,1713.1
4521814295,14,6,0,7,4,7,1,0,1,0,16806,6.8,17149,217,50,1904,892,21.7,1680.6,38,6,1,4,7,4,0,0,0,0,14902,6.4,16257,200,55,-1904,-892,20.0,1490.2
4499816860,26,3,1,4,5,4,1,1,0,0,15273,6.8,17539,211,60,-808,-311,21.1,1527.3,20,1,0,5,4,6,0,0,0,0,16081,7.2,17850,238,45,808,311,23.8,1608.1
4516930956,12,2,0,6,15,6,0,0,0,0,15392,6.4,16156,175,45,-4885,-3111,17.5,1539.2,16,3,1,15,6,17,1,0,1,0,20277,7.4,19267,233,46,4885,3111,23.3,2027.7
4447657197,35,4,1,13,8,11,0,0,0,1,20341,7.4,19192,235,40,3202,2467,23.5,2034.1,24,6,0,8,13,10,1,1,0,0,17139,6.6,16725,189,48,-3202,-2467,18.9,1713.9
4513183607,45,5,1,8,6,11,1,1,0,0,17405,7.0,18074,204,51,1059,-338,20.4,1740.5,10,5,0,6,8,9,0,0,0,0,16346,7.0,18412,221,36,-1059,338,22.1,1634.6
4524604603,19,3,1,8,6,7,0,0,0,0,17394,6.8,17390,199,68,1377,-221,19.9,1739.4,13,2,0,6,8,5,2,1,1,0,16017,6.8,17611,218,55,-1377,221,21.8,1601.7
4481875944,14,2,0,7,11,7,0,0,0,0,15177,6.4,15795,152,36,-3891,-2689,15.2,1517.7,41,0,1,11,7,9,0,0,0,0,19068,7.2,18484,218,43,3891,2689,21.8,1906.8
4518526662,32,1,1,7,6,9,2,1,1,0,17140,6.8,18226,221,68,597,875,22.1,1714.0,15,3,0,6,7,7,0,0,0,0,16543,6.8,17351,226,57,-597,-875,22.6,1654.3
4525831226,59,1,0,0,1,0,1,1,0,0,14457,7.0,18824,230,72,-832,541,23.0,1445.7,20,0,1,1,0,1,0,0,0,0,15289,7.0,18283,267,63,832,-541,26.7,1528.9
4496999459,18,5,0,0,3,0,0,0,0,0,13691,6.8,16957,229,54,-1148,-818,22.9,1369.1,17,4,1,3,0,2,0,0,0,0,14839,6.8,17775,221,51,1148,818,22.1,1483.9
4511873331,41,1,1,7,4,7,1,1,0,0,17070,7.2,18583,223,47,1451,1441,22.3,1707.0,12,1,0,4,7,4,0,0,0,0,15619,6.8,17142,199,56,-1451,-1441,19.9,1561.9
4520601496,16,1,0,8,6,10,0,0,0,0,18029,7.2,18791,199,53,2323,1699,19.9,1802.9,15,2,1,6,8,5,0,0,0,0,15706,6.8,17092,192,38,-2323,-1699,19.2,1570.6
4523542787,17,1,0,3,5,4,0,0,0,0,14776,6.8,17631,203,64,-1960,-1464,20.3,1477.6,13,2,1,5,3,5,1,1,0,0,16736,7.2,19095,252,56,1960,1464,25.2,1673.6
4523056816,16,2,1,7,2,8,0,0,0,0,16861,7.2,18561,196,51,2211,1501,19.6,1686.1,33,1,0,2,7,1,1,1,0,0,14650,7.0,17060,208,48,-2211,-1501,20.8,1465.0
4496724887,23,5,1,8,2,13,1,1,0,0,17575,7.2,18579,228,52,2658,1915,22.8,1757.5,18,3,0,2,8,2,0,0,0,0,14917,6.6,16664,211,50,-2658,-1915,21.1,1491.7
4513262976,18,5,0,4,1,9,1,1,0,0,15357,6.8,17204,200,59,1273,1061,20.0,1535.7,16,5,1,1,4,2,0,0,0,0,14084,6.4,16143,239,40,-1273,-1061,23.9,1408.4
4527033024,13,0,0,11,2,15,1,1,0,0,19508,7.4,19814,233,60,4882,2658,23.3,1950.8,13,1,1,2,11,1,0,0,0,0,14626,6.8,17156,219,60,-4882,-2658,21.9,1462.6
4517670386,43,3,0,1,14,1,0,0,0,0,13172,6.0,14988,187,28,-7079,-4936,18.7,1317.2,15,5,1,14,1,21,1,1,0,0,20251,7.4,19924,222,63,7079,4936,22.2,2025.1
4478381770,19,7,0,1,6,1,0,0,0,0,14910,6.8,17888,245,56,-1557,-1039,24.5,1491.0,16,7,1,6,1,7,1,1,0,0,16467,7.2,18927,225,56,1557,1039,22.5,1646.7
4521266857,18,4,1,3,6,1,0,0,0,0,15177,6.8,17645,220,52,-1716,-2811,22.0,1517.7,21,1,0,6,3,4,0,0,0,0,16893,7.4,20456,241,64,1716,2811,24.1,1689.3
4527767522,18,4,0,6,2,8,1,1,0,0,16055,7.0,18838,208,64,583,439,20.8,1605.5,38,5,1,2,6,1,0,0,0,0,15472,7.2,18399,259,54,-583,-439,25.9,1547.2
4522301091,18,5,1,7,6,6,0,0,0,0,15954,6.8,16128,211,27,654,823,21.1,1595.4,20,1,0,6,7,6,1,0,1,0,15300,6.2,15305,190,40,-654,-823,19.0,1530.0
4522178683,33,0,0,2,10,2,0,0,0,0,13555,6.0,13939,150,48,-6373,-5156,15.0,1355.5,20,1,1,10,2,9,2,1,1,1,19928,7.2,19095,242,56,6373,5156,24.2,1992.8
4521563183,15,2,0,5,6,3,0,0,0,0,16495,7.0,18518,230,46,955,748,23.0,1649.5,36,3,1,6,5,6,0,0,0,0,15540,6.8,17770,164,58,-955,-748,16.4,1554.0
4514107032,17,0,1,4,2,4,0,0,0,0,17186,7.0,19734,263,72,2478,1105,26.3,1718.6,16,6,0,2,4,3,2,1,1,0,14708,7.0,18629,209,60,-2478,-1105,20.9,1470.8
4496160453,14,2,0,6,7,5,0,0,0,0,16169,6.6,17326,214,42,-620,-1984,21.4,1616.9,18,5,1,7,6,4,2,1,1,0,16789,7.0,19310,237,56,620,1984,23.7,1678.9
4498748724,35,2,1,5,3,7,1,0,1,0,15588,6.6,16904,202,44,414,-1224,20.2,1558.8,40,3,0,3,5,2,1,1,0,0,15174,7.0,18128,207,68,-414,1224,20.7,1517.4
4511791303,15,1,1,5,3,2,1,1,0,0,16421,7.0,18152,241,48,1239,-1051,24.1,1642.1,42,1,0,3,5,2,0,0,0,0,15182,7.2,19203,219,73,-1239,1051,21.9,1518.2
4526014315,15,2,0,2,9,4,0,0,0,0,15074,6.8,16329,225,52,-1673,-1730,22.5,1507.4,13,4,1,9,2,10,1,1,0,0,16747,7.0,18059,215,52,1673,1730,21.5,1674.7
4524065745,21,4,0,10,12,16,1,1,0,0,18676,7.0,18145,217,76,416,1133,21.7,1867.6,20,1,1,12,10,14,0,0,0,0,18260,6.6,17012,211,31,-416,-1133,21.1,1826.0
4429821639,11,2,1,11,2,9,2,1,1,0,17435,7.0,19432,236,52,1220,589,23.6,1743.5,14,2,0,2,11,2,0,0,0,0,16215,7.0,18843,241,68,-1220,-589,24.1,1621.5
4521530556,17,1,0,10,5,11,1,1,0,0,17920,7.0,18730,224,51,2536,746,22.4,1792.0,37,4,1,5,10,5,0,0,0,0,15384,7.0,17984,220,48,-2536,-746,22.0,1538.4
4508573055,21,6,0,4,2,7,0,0,0,0,14866,6.8,17470,191,51,103,412,19.1,1486.6,21,6,1,2,4,3,1,0,1,0,14763,6.8,17058,239,41,-103,-412,23.9,1476.3
4522834412,42,5,1,8,7,11,1,1,0,0,17971,7.0,19666,209,64,523,-69,20.9,1797.1,24,5,0,7,8,9,0,0,0,0,17448,7.2,19735,237,61,-523,69,23.7,1744.8
4468830390,25,2,0,14,9,16,1,1,0,0,19904,7.0,18106,179,60,2685,1605,17.9,1990.4,17,4,1,9,14,7,0,0,0,0,17219,6.6,16501,205,44,-2685,-1605,20.5,1721.9
4525230737,12,4,0,7,7,9,0,0,0,0,16696,6.8,17704,202,52,-422,-43,20.2,1669.6,28,1,1,7,7,10,2,1,1,0,17118,7.0,17747,189,53,422,43,18.9,1711.8
4518971206,20,3,0,7,4,8,0,0,0,0,16472,7.2,18966,219,53,1367,2396,21.9,1647.2,15,4,1,4,7,4,1,0,1,0,15105,6.6,16570,180,45,-1367,-2396,18.0,1510.5
4514750583,13,1,1,6,2,4,0,0,0,0,16853,6.8,18346,234,44,2097,1569,23.4,1685.3,106,2,0,2,6,1,0,0,0,0,14756,6.6,16777,228,50,-2097,-1569,22.8,1475.6
4521984246,14,3,1,5,6,5,1,1,0,0,16331,7.0,17720,231,44,-377,-1234,23.1,1633.1,21,5,0,6,5,7,0,0,0,0,16708,7.2,18954,229,56,377,1234,22.9,1670.8
4492190443,16,2,1,6,4,11,0,0,0,0,16731,7.0,17558,239,49,2073,2090,23.9,1673.1,15,4,0,4,6,4,0,0,0,0,14658,6.4,15468,203,38,-2073,-2090,20.3,1465.8
4465014054,25,3,1,3,3,3,0,0,0,0,15365,6.8,17502,250,49,-528,-1130,25.0,1536.5,19,6,0,3,3,4,1,1,0,0,15893,7.0,18632,259,55,528,1130,25.9,1589.3
4519145907,13,3,0,4,6,3,2,1,1,0,15695,7.2,18493,238,44,-300,451,23.8,1569.5,11,2,1,6,4,5,0,0,0,0,15995,7.2,18042,203,51,300,-451,20.3,1599.5
4454963096,31,3,1,7,6,8,1,1,0,0,16972,7.0,18412,221,51,1807,733,22.1,1697.2,14,1,0,6,7,3,1,0,1,0,15165,7.0,17679,211,40,-1807,-733,21.1,1516.5
4503839400,18,1,0,5,9,4,0,0,0,0,15167,6.6,16733,195,56,-2132,-1088,19.5,1516.7,17,3,1,9,5,7,0,0,0,0,17299,7.0,17821,215,42,2132,1088,21.5,1729.9
4520894516,38,4,1,5,7,4,0,0,0,0,16562,7.2,18781,210,64,44,170,21.0,1656.2,21,1,0,7,5,8,1,1,0,0,16518,7.0,18611,245,36,-44,-170,24.5,1651.8
4459704027,18,19,1,5,2,7,1,1,0,0,16858,7.2,18543,251,39,2407,939,25.1,1685.8,43,1,0,2,5,3,0,0,0,0,14451,6.6,17604,221,44,-2407,-939,22.1,1445.1
4525069847,15,5,0,5,4,6,1,0,1,1,17610,6.8,18110,232,57,1467,11,23.2,1761.0,46,1,1,4,5,6,1,1,0,0,16143,7.0,18099,222,56,-1467,-11,22.2,1614.3
4460661408,17,5,0,7,4,8,1,1,0,0,17863,7.4,19967,257,39,3109,3007,25.7,1786.3,13,2,1,4,7,5,0,0,0,0,14754,6.4,16960,204,44,-3109,-3007,20.4,1475.4
4506223983,18,2,1,11,7,9,1,1,0,0,18913,6.6,17351,229,38,3002,1582,22.9,1891.3,9,2,0,7,11,8,0,0,0,0,15911,6.4,15769,170,45,-3002,-1582,17.0,1591.1
4524424750,18,2,1,8,6,6,0,0,0,0,16691,6.8,16656,191,64,-1421,-1364,19.1,1669.1,25,6,0,6,8,7,0,0,0,1,18112,7.0,18020,237,51,1421,1364,23.7,1811.2
4522859365,16,5,0,9,2,16,1,1,0,0,18984,7.4,20083,254,54,4620,2871,25.4,1898.4,16,2,1,2,9,3,0,0,0,0,14364,6.6,17212,171,59,-4620,-2871,17.1,1436.4
4513811621,19,1,0,11,3,14,0,0,0,0,19373,7.2,19208,228,40,4898,3092,22.8,1937.3,14,2,1,3,11,2,1,1,0,0,14475,6.6,16116,190,60,-4898,-3092,19.0,1447.5
4525084228,19,5,0,4,4,4,0,0,0,0,14892,6.8,17899,199,49,-1750,-628,19.9,1489.2,19,4,1,4,4,4,1,1,0,0,16642,7.2,18527,250,61,1750,628,25.0,1664.2
4523781567,10,3,0,5,5,4,0,0,0,0,16368,7.0,18622,250,48,1079,1363,25.0,1636.8,14,3,1,5,5,7,1,1,0,0,15289,7.0,17259,206,56,-1079,-1363,20.6,1528.9
4486544471,12,2,0,10,9,10,0,0,0,0,17706,6.8,17870,212,48,578,144,21.2,1770.6,11,1,1,9,10,6,0,0,0,0,17128,7.0,17726,204,38,-578,-144,20.4,1712.8
4474893713,16,1,1,12,7,14,2,1,1,0,19592,7.2,19231,235,53,3214,2261,23.5,1959.2,54,1,0,7,12,5,0,0,0,0,16378,7.0,16970,184,49,-3214,-2261,18.4,1637.8
4489679008,16,2,0,3,4,0,0,0,0,0,15139,6.8,17354,240,48,-243,799,24.0,1513.9,17,1,1,4,3,10,1,1,0,0,15382,6.6,16555,206,52,243,-799,20.6,1538.2
4510820768,11,0,1,7,2,7,1,1,0,0,18117,7.4,19804,236,72,5779,5212,23.6,1811.7,17,0,0,2,7,0,0,0,0,0,12338,5.6,14592,197,8,-5779,-5212,19.7,1233.8
4489963680,77,3,1,8,11,12,1,0,1,0,16842,6.4,16280,210,28,-1725,-2264,21.0,1684.2,39,1,0,11,8,13,1,1,0,0,18567,7.0,18544,192,56,1725,2264,19.2,1856.7
4504197539,13,2,0,3,5,3,0,0,0,0,15553,7.2,18934,244,55,-1449,-349,24.4,1555.3,41,5,1,5,3,3,0,0,0,0,17002,7.2,19283,250,76,1449,349,25.0,1700.2
4516254148,16,1,0,7,8,8,1,1,0,0,16586,6.8,17047,226,50,-787,-1921,22.6,1658.6,39,7,1,8,7,7,0,0,0,0,17373,7.2,18968,207,56,787,1921,20.7,1737.3
4521886990,20,3,1,7,2,13,1,1,0,0,17075,6.8,17444,202,56,1531,-222,20.2,1707.5,14,6,0,2,7,2,0,0,0,0,15544,6.8,17666,252,48,-1531,222,25.2,1554.4
4526265096,15,2,1,9,6,5,1,0,1,0,16994,7.6,19700,225,40,446,2153,22.5,1699.4,14,2,0,6,9,5,1,1,0,0,16548,6.8,17547,234,42,-446,-2153,23.4,1654.8
4482162285,75,1,0,7,7,11,0,0,0,0,16600,7.0,18623,195,49,-335,262,19.5,1660.0,12,1,1,7,7,6,0,0,0,0,16935,7.2,18361,206,58,335,-262,20.6,1693.5
4515215762,17,3,0,8,3,8,2,1,1,0,17500,6.8,18340,229,55,3308,2114,22.9,1750.0,9,0,1,3,8,3,0,0,0,0,14192,6.6,16226,215,28,-3308,-2114,21.5,1419.2
4483926766,15,4,0,5,10,5,1,0,1,0,14982,6.6,15862,171,48,-2690,-743,17.1,1498.2,81,5,1,10,5,14,0,0,0,0,17672,6.6,16605,187,36,2690,743,18.7,1767.2
4469595642,18,4,0,9,9,12,2,1,1,0,17732,7.2,19451,194,70,-532,298,19.4,1773.2,21,5,1,9,9,8,0,0,0,0,18264,7.2,19153,208,72,532,-298,20.8,1826.4
4486520653,11,1,1,7,4,5,0,0,0,0,17052,6.8,17766,241,44,1475,-95,24.1,1705.2,36,2,0,4,7,5,1,1,0,0,15577,6.6,17861,206,60,-1475,95,20.6,1557.7
4462139744,27,5,1,15,3,14,2,1,1,1,20567,7.4,19536,221,42,6487,4018,22.1,2056.7,19,6,0,3,15,1,0,0,0,0,14080,6.2,15518,197,46,-6487,-4018,19.7,1408.0
4467412400,17,1,1,1,3,1,0,0,0,0,15573,7.0,18440,246,70,66,319,24.6,1557.3,130,4,0,3,1,6,2,1,1,0,15507,7.0,18121,233,57,-66,-319,23.3,1550.7
4515507171,14,3,0,5,5,4,1,1,0,0,16313,7.0,18652,242,47,-152,-537,24.2,1631.3,18,4,1,5,5,5,0,0,0,0,16465,7.2,19189,213,64,152,537,21.3,1646.5
4495693355,18,1,0,3,4,1,1,1,0,0,15701,7.0,17966,245,44,826,-382,24.5,1570.1,13,1,1,4,3,6,0,0,0,0,14875,7.0,18348,193,62,-826,382,19.3,1487.5
4477060044,18,0,0,3,6,2,0,0,0,0,14364,7.0,17602,190,56,-3333,-1389,19.0,1436.4,20,2,1,6,3,6,1,1,0,0,17697,7.2,18991,251,45,3333,1389,25.1,1769.7
4476715890,16,3,1,11,4,7,1,1,0,0,18303,7.2,19093,214,54,3586,2697,21.4,1830.3,16,1,0,4,11,2,0,0,0,0,14717,6.4,16396,180,46,-3586,-2697,18.0,1471.7
4434070887,16,3,0,14,3,18,1,1,0,0,18413,7.2,19646,196,61,3994,3953,19.6,1841.3,15,1,1,3,14,2,0,0,0,0,14419,6.2,15693,213,40,-3994,-3953,21.3,1441.9
4466899490,12,3,1,5,6,7,1,1,0,0,16209,7.0,18162,231,52,55,-1918,23.1,1620.9,15,5,0,6,5,3,0,0,0,0,16154,7.2,20080,228,64,-55,1918,22.8,1615.4
4518092454,15,3,0,5,9,5,0,0,0,0,15529,6.8,17544,200,52,-2347,-1346,20.0,1552.9,14,2,1,9,5,9,1,0,1,0,17876,7.2,18890,229,55,2347,1346,22.9,1787.6
4517750009,12,2,1,6,7,9,1,1,0,0,16815,7.2,17824,235,48,683,-208,23.5,1681.5,15,0,0,7,6,12,1,0,1,0,16132,6.8,18032,179,48,-683,208,17.9,1613.2
4523082627,16,3,1,5,4,4,0,0,0,1,17305,7.2,18581,246,40,2319,135,24.6,1730.5,15,2,0,4,5,2,1,1,0,0,14986,7.0,18446,217,59,-2319,-135,21.7,1498.6
4499849238,24,3,0,8,6,7,2,1,1,0,17527,7.2,19414,236,64,1625,1945,23.6,1752.7,16,2,1,6,8,2,0,0,0,0,15902,6.8,17469,208,52,-1625,-1945,20.8,1590.2
4481377931,16,3,0,4,9,5,1,0,1,0,15664,6.8,17373,208,60,-2078,-188,20.8,1566.4,16,2,1,9,4,10,1,1,0,0,17742,7.0,17561,214,44,2078,188,21.4,1774.2
4471977008,15,4,0,5,6,3,1,1,0,0,16298,7.4,19831,231,64,96,2988,23.1,1629.8,17,2,1,6,5,8,0,0,0,0,16202,6.6,16843,201,44,-96,-2988,20.1,1620.2
4502491381,12,4,1,6,9,5,0,0,0,0,15967,6.6,17065,217,47,-2162,-2253,21.7,1596.7,41,5,0,9,6,9,0,0,0,0,18129,7.2,19318,224,53,2162,2253,22.4,1812.9
4522867011,15,1,0,3,6,0,1,0,1,0,15189,6.6,17014,225,56,-1720,-2056,22.5,1518.9,12,4,1,6,3,3,1,1,0,0,16909,7.2,19070,248,61,1720,2056,24.8,1690.9
4501239867,11,1,0,8,8,10,0,0,0,0,17208,7.2,18713,231,45,-737,667,23.1,1720.8,12,1,1,8,8,10,0,0,0,0,17945,6.8,18046,239,29,737,-667,23.9,1794.5
4523591734,37,3,0,5,9,5,0,0,0,0,15440,6.4,15725,180,43,-1729,118,18.0,1544.0,17,2,1,9,5,8,0,0,0,0,17169,6.4,15607,185,44,1729,-118,18.5,1716.9
4488648117,26,3,0,4,5,3,0,0,0,0,14925,7.0,18636,218,49,-1375,-850,21.8,1492.5,16,7,1,5,4,4,1,1,0,0,16300,7.6,19486,220,76,1375,850,22.0,1630.0
4501240960,16,2,0,5,5,6,1,1,0,0,16046,6.8,17207,234,41,699,18,23.4,1604.6,14,0,1,5,5,6,0,0,0,0,15347,6.6,17189,199,52,-699,-18,19.9,1534.7
4442045981,73,1,1,9,4,5,1,1,0,0,17965,7.4,20621,229,64,2954,4490,22.9,1796.5,19,1,0,4,9,8,0,0,0,0,15011,6.4,16131,208,41,-2954,-4490,20.8,1501.1
4525945440,15,4,0,4,9,7,1,1,0,0,15315,7.0,17674,188,62,-2881,-981,18.8,1531.5,18,4,1,9,4,11,1,0,1,0,18196,7.0,18655,230,39,2881,981,23.0,1819.6
4480568800,15,5,0,7,5,6,1,0,1,0,17323,7.2,18801,240,49,1248,-243,24.0,1732.3,21,2,1,5,7,4,1,1,0,0,16075,7.2,19044,222,58,-1248,243,22.2,1607.5
4494877366,90,1,0,6,7,6,1,1,0,0,17242,7.0,18478,230,75,1291,2116,23.0,1724.2,18,3,1,7,6,8,0,0,0,0,15951,6.6,16362,171,27,-1291,-2116,17.1,1595.1
4501385353,53,3,1,12,5,17,0,0,0,0,17838,6.8,17217,194,42,2554,1453,19.4,1783.8,18,3,0,5,12,5,0,0,0,0,15284,6.4,15764,215,41,-2554,-1453,21.5,1528.4
4514601074,46,3,1,10,7,6,1,1,0,0,17678,7.4,18832,189,76,1754,433,18.9,1767.8,13,2,0,7,10,4,0,0,0,0,15924,6.8,18399,207,54,-1754,-433,20.7,1592.4
4520734931,42,4,0,3,5,4,0,0,0,0,15314,7.0,18205,233,52,-1659,-1566,23.3,1531.4,18,5,1,5,3,5,0,0,0,0,16973,7.4,19771,253,60,1659,1566,25.3,1697.3
4522471195,18,8,1,4,4,4,0,0,0,0,15597,6.8,17541,232,36,717,215,23.2,1559.7,15,2,0,4,4,3,1,1,0,0,14880,6.8,17326,197,52,-717,-215,19.7,1488.0
4514363015,16,2,1,4,8,5,1,1,0,0,15179,6.8,16562,220,49,-2967,-4209,22.0,1517.9,43,2,0,8,4,7,0,0,0,0,18146,7.6,20771,266,54,2967,4209,26.6,1814.6
4492655929,13,2,0,6,14,4,0,0,0,0,15484,7.0,17528,188,46,-5634,-3787,18.8,1548.4,15,5,1,14,6,9,1,1,0,0,21118,7.8,21315,243,52,5634,3787,24.3,2111.8
4509900585,20,5,1,8,3,12,1,1,0,0,17562,7.0,17702,237,43,3575,1394,23.7,1756.2,42,2,0,3,8,1,1,0,1,0,13987,6.6,16308,176,45,-3575,-1394,17.6,1398.7
4499266500,19,6,0,3,6,3,1,1,0,0,15025,6.6,17533,234,44,-2963,-1630,23.4,1502.5,59,3,1,6,3,6,1,0,1,0,17988,7.2,19163,252,56,2963,1630,25.2,1798.8
4523827809,26,4,0,5,3,6,2,1,1,0,15947,7.0,18280,219,64,402,890,21.9,1594.7,14,5,1,3,5,3,0,0,0,0,15545,7.0,17390,237,55,-402,-890,23.7,1554.5
4502054946,15,4,0,8,4,11,0,0,0,0,17476,7.2,19033,245,52,1716,1970,24.5,1747.6,15,3,1,4,8,8,0,0,0,0,15760,6.6,17063,209,48,-1716,-1970,20.9,1576.0
4511735384,16,1,1,9,3,8,2,1,1,0,18599,7.2,20735,216,76,3821,4288,21.6,1859.9,34,1,0,3,9,5,0,0,0,0,14778,6.8,16447,187,56,-3821,-4288,18.7,1477.8
4527040336,16,6,1,5,4,5,0,0,0,0,15452,6.6,16236,195,35,926,-849,19.5,1545.2,17,2,0,4,5,4,1,1,0,0,14526,6.8,17085,186,44,-926,849,18.6,1452.6
4472722581,13,4,0,5,4,4,0,0,0,0,17039,7.4,19626,261,60,1116,1123,26.1,1703.9,17,1,1,4,5,3,1,1,0,0,15923,7.0,18503,221,60,-1116,-1123,22.1,1592.3
4484101947,14,1,1,2,5,2,0,0,0,0,14985,7.0,17710,224,60,-1522,-1437,22.4,1498.5,14,2,0,5,2,5,1,1,0,0,16507,7.2,19147,253,56,1522,1437,25.3,1650.7
4525128614,24,2,1,8,8,9,0,0,0,0,17238,6.8,17944,209,44,894,-3,20.9,1723.8,15,2,0,8,8,10,0,0,0,0,16344,7.0,17947,187,44,-894,3,18.7,1634.4
4518296609,15,3,0,5,4,6,1,1,0,0,16086,7.0,18044,222,68,441,626,22.2,1608.6,16,2,1,4,5,5,0,0,0,0,15645,6.8,17418,235,44,-441,-626,23.5,1564.5
4512807335,12,2,0,2,4,3,0,0,0,0,14593,6.6,17874,240,38,-1972,-1177,24.0,1459.3,12,2,1,4,2,5,0,0,0,0,16565,7.2,19051,253,64,1972,1177,25.3,1656.5
4498809510,46,1,0,1,8,0,1,0,1,0,14206,7.0,17314,218,64,-2855,-1603,21.8,1420.6,16,14,1,8,1,8,1,1,0,0,17061,7.0,18917,228,56,2855,1603,22.8,1706.1
4526588067,122,4,0,5,5,7,1,0,1,1,17716,7.0,17963,216,44,8,-625,21.6,1771.6,15,3,1,5,5,4,1,1,0,0,17708,7.2,18588,249,68,-8,625,24.9,1770.8
4520391395,17,1,1,8,10,9,1,0,1,1,18374,7.2,18219,218,54,1142,969,21.8,1837.4,14,0,0,10,8,14,0,0,0,0,17232,6.8,17250,188,50,-1142,-969,18.8,1723.2
4522510473,138,4,0,6,4,8,0,0,0,0,15096,6.2,15415,199,32,-120,-1620,19.9,1509.6,15,3,1,4,6,2,1,1,0,0,15216,6.4,17035,193,67,120,1620,19.3,1521.6
4505326762,18,4,0,10,6,14,0,0,0,0,18270,7.0,18940,234,50,1927,495,23.4,1827.0,15,2,1,6,10,7,2,1,1,0,16343,7.0,18445,224,49,-1927,-495,22.4,1634.3
4453252980,42,5,0,0,9,0,0,0,0,0,13024,6.6,15869,192,48,-4912,-4457,19.2,1302.4,19,8,1,9,0,5,2,1,1,0,17936,7.4,20326,251,51,4912,4457,25.1,1793.6
4525553823,14,0,0,10,4,13,1,1,0,0,19359,7.2,19182,243,53,4424,2663,24.3,1935.9,53,4,1,4,10,5,0,0,0,0,14935,6.8,16519,189,62,-4424,-2663,18.9,1493.5
4490919481,58,4,1,3,7,4,1,1,0,0,13957,6.4,16250,187,48,-2788,-1304,18.7,1395.7,15,5,0,7,3,10,0,0,0,0,16745,6.8,17554,210,48,2788,1304,21.0,1674.5
4525024400,15,23,0,8,13,12,0,0,0,0,16342,6.6,16909,165,42,-5219,-3480,16.5,1634.2,41,2,1,13,8,15,0,0,0,1,21561,7.4,20389,263,40,5219,3480,26.3,2156.1
4498876812,16,0,0,3,10,1,0,0,0,0,14689,6.6,16533,195,52,-3089,-2151,19.5,1468.9,14,2,1,10,3,16,1,1,0,0,17778,7.0,18684,219,48,3089,2151,21.9,1777.8
4494820470,10,3,1,7,8,9,1,1,0,0,16890,6.8,17686,221,53,-1647,-1443,22.1,1689.0,11,1,0,8,7,9,1,0,1,0,18537,7.2,19129,223,60,1647,1443,22.3,1853.7
4517985377,15,1,1,8,9,7,0,0,0,0,17697,6.8,16356,208,41,118,-2044,20.8,1769.7,14,2,0,9,8,5,1,1,0,0,17579,7.2,18400,200,59,-118,2044,20.0,1757.9
4517796937,13,7,1,10,9,12,1,1,0,0,17828,7.0,18635,184,59,371,514,18.4,1782.8,16,2,0,9,10,9,1,0,1,0,17457,7.0,18121,219,35,-371,-514,21.9,1745.7
4517738815,16,2,1,4,6,3,0,0,0,0,15865,7.0,18037,225,50,-517,-425,22.5,1586.5,16,2,0,6,4,8,1,1,0,0,16382,6.8,18462,244,45,517,425,24.4,1638.2
4514180847,17,3,1,10,5,12,2,1,1,0,18625,7.2,18897,223,63,3149,2125,22.3,1862.5,17,1,0,5,10,4,0,0,0,0,15476,6.8,16772,227,40,-3149,-2125,22.7,1547.6
4438230274,16,2,0,3,6,5,0,0,0,0,14448,6.4,15930,209,40,-1620,-1431,20.9,1444.8,17,2,1,6,3,10,1,0,1,0,16068,6.8,17361,204,51,1620,1431,20.4,1606.8
4524523672,41,6,0,4,7,4,1,1,0,0,14969,6.8,16927,195,45,-1404,-509,19.5,1496.9,19,4,1,7,4,6,0,0,0,0,16373,6.8,17436,206,46,1404,509,20.6,1637.3
4494288234,38,0,1,8,2,8,0,0,0,0,18274,7.0,18615,238,45,3803,2825,23.8,1827.4,15,0,0,2,8,6,0,0,0,0,14471,6.4,15790,201,51,-3803,-2825,20.1,1447.1
4513365614,16,1,0,5,5,8,0,0,0,0,15851,6.8,17366,206,56,-808,-1655,20.6,1585.1,38,6,1,5,5,6,0,0,0,0,16659,7.2,19021,241,44,808,1655,24.1,1665.9
4504190601,20,3,0,2,9,2,0,0,0,0,14944,6.6,17675,239,47,-2695,-1275,23.9,1494.4,14,3,1,9,2,9,1,1,0,0,17639,7.0,18950,252,46,2695,1275,25.2,1763.9
4517825338,16,4,1,7,2,6,0,0,0,0,17423,7.4,19973,248,55,2822,2207,24.8,1742.3,24,3,0,2,7,2,1,1,0,0,14601,7.0,17766,219,64,-2822,-2207,21.9,1460.1
4508648628,30,1,0,3,9,2,1,0,1,0,14423,7.2,17518,188,59,-2911,-286,18.8,1442.3,12,1,1,9,3,12,0,0,0,0,17334,6.8,17804,201,38,2911,286,20.1,1733.4
4469976070,14,2,1,7,6,8,1,1,0,0,15632,6.2,15789,196,32,-1339,-2802,19.6,1563.2,17,2,0,6,7,8,1,0,1,0,16971,7.0,18591,216,67,1339,2802,21.6,1697.1
4493407357,78,4,1,9,3,10,0,0,0,0,17983,7.0,18340,230,52,4009,1935,23.0,1798.3,18,0,0,3,9,1,1,0,1,0,13974,6.6,16405,183,49,-4009,-1935,18.3,1397.4
4427468467,13,4,0,5,2,5,1,1,0,0,15182,7.0,17949,205,44,246,759,20.5,1518.2,20,1,1,2,5,2,1,0,1,0,14936,7.0,17190,230,56,-246,-759,23.0,1493.6
4475415564,24,1,0,9,5,4,1,0,1,0,17535,7.2,19338,236,60,1782,2856,23.6,1753.5,13,2,1,5,9,6,1,1,0,0,15753,6.8,16482,207,40,-1782,-2856,20.7,1575.3
4461203281,17,3,0,1,9,2,0,0,0,0,13570,6.2,15620,194,52,-6578,-4807,19.4,1357.0,21,3,1,9,1,8,2,1,1,1,20148,7.2,20427,267,63,6578,4807,26.7,2014.8
4522582067,15,0,0,6,9,8,0,0,0,0,15591,6.6,16788,204,35,-2322,-2808,20.4,1559.1,15,1,1,9,6,7,1,1,0,0,17913,7.2,19596,216,60,2322,2808,21.6,1791.3
4479804307,16,2,1,10,6,12,1,1,0,0,18439,7.2,18689,223,39,1894,99,22.3,1843.9,12,4,0,6,10,5,0,0,0,0,16545,7.0,18590,203,48,-1894,-99,20.3,1654.5
4499534916,18,4,1,8,1,5,2,1,1,1,19383,7.6,21403,271,59,4656,3776,27.1,1938.3,12,2,0,1,8,0,0,0,0,0,14727,6.8,17627,249,58,-4656,-3776,24.9,1472.7
4519461793,18,1,0,4,7,7,0,0,0,0,15818,6.8,17864,233,47,-60,1347,23.3,1581.8,62,3,1,7,4,13,1,1,0,0,15878,6.6,16517,186,36,60,-1347,18.6,1587.8
4439747783,23,2,0,3,8,6,0,0,0,0,14517,6.4,15493,169,46,-3525,-3278,16.9,1451.7,13,0,1,8,3,15,2,1,1,0,18042,7.0,18771,202,79,3525,3278,20.2,1804.2
4484545103,17,0,1,8,7,7,0,0,0,0,16885,6.6,17748,220,40,-11,-1495,22.0,1688.5,12,6,0,7,8,6,1,1,0,0,16896,7.2,19243,213,60,11,1495,21.3,1689.6
4517922682,35,4,0,7,5,10,0,0,0,0,16526,7.2,19072,217,56,-64,239,21.7,1652.6,66,2,1,5,7,4,0,0,0,0,16590,7.0,18833,214,60,64,-239,21.4,1659.0
4520853492,19,2,0,11,7,14,1,0,1,0,18361,7.0,18709,234,43,1531,1680,23.4,1836.1,12,2,1,7,11,13,1,1,0,0,16830,6.8,17029,207,44,-1531,-1680,20.7,1683.0
4519502337,17,4,0,9,6,12,1,1,0,0,18555,7.2,19740,250,56,2976,1300,25.0,1855.5,16,3,1,6,9,6,0,0,0,0,15579,7.0,18440,207,48,-2976,-1300,20.7,1557.9
4492994895,11,2,1,4,4,0,1,0,1,0,15620,7.2,18558,239,56,-1761,-385,23.9,1562.0,18,0,0,4,4,8,1,1,0,1,17381,7.4,18943,243,54,1761,385,24.3,1738.1
4527001202,13,3,1,7,12,8,1,1,0,0,16763,7.0,17386,221,45,-1469,-2427,22.1,1676.3,11,1,0,12,7,10,0,0,0,0,18232,7.4,19813,214,44,1469,2427,21.4,1823.2
4518463006,40,3,0,10,8,10,0,0,0,0,17546,7.2,18498,191,44,510,921,19.1,1754.6,14,2,1,8,10,7,1,1,0,0,17036,7.0,17577,217,51,-510,-921,21.7,1703.6
4493865570,13,1,1,4,1,3,2,1,1,0,17220,7.4,19745,233,52,3373,2086,23.3,1722.0,13,0,0,1,4,0,0,0,0,0,13847,7.0,17659,225,51,-3373,-2086,22.5,1384.7
4488986123,15,4,0,7,5,8,1,1,0,0,16787,6.8,17483,208,40,800,-237,20.8,1678.7,14,2,1,5,7,7,0,0,0,0,15987,6.8,17720,236,44,-800,237,23.6,1598.7
4515342785,15,2,1,6,5,4,1,1,0,0,15698,7.0,17468,206,59,-1143,-859,20.6,1569.8,15,1,0,5,6,3,1,0,1,0,16841,7.0,18327,259,50,1143,859,25.9,1684.1
4525383403,12,1,1,2,13,1,0,0,0,0,14218,6.2,15368,200,49,-4511,-4211,20.0,1421.8,17,3,0,13,2,18,1,1,0,0,18729,7.4,19579,213,44,4511,4211,21.3,1872.9
4522519363,16,4,0,5,3,4,1,1,0,0,16338,7.2,19137,234,60,1106,1309,23.4,1633.8,18,1,1,3,5,1,0,0,0,0,15232,6.8,17828,228,60,-1106,-1309,22.8,1523.2
4516320607,12,1,0,7,5,6,1,1,0,0,15900,7.0,18137,206,48,-435,-960,20.6,1590.0,34,2,1,5,7,4,0,0,0,0,16335,7.0,19097,218,77,435,960,21.8,1633.5
4518592520,14,2,1,7,1,4,1,1,0,0,16614,7.0,18570,221,50,3295,3468,22.1,1661.4,14,2,0,1,7,0,0,0,0,0,13319,6.4,15102,205,50,-3295,-3468,20.5,1331.9
4453181385,15,4,0,7,5,4,2,1,1,0,16372,7.2,19294,208,54,1162,2078,20.8,1637.2,14,4,1,5,7,5,0,0,0,0,15210,7.0,17216,193,40,-1162,-2078,19.3,1521.0
4492541051,22,3,1,7,2,3,0,0,0,0,16729,7.2,19694,231,56,2248,3163,23.1,1672.9,14,2,0,2,7,1,0,0,0,0,14481,6.4,16531,206,53,-2248,-3163,20.6,1448.1
4525013818,14,1,0,8,8,7,0,0,0,0,16072,6.6,16342,214,42,-1247,-835,21.4,1607.2,21,2,1,8,8,12,1,1,0,0,17319,6.6,17177,229,41,1247,835,22.9,1731.9
4500690189,17,2,1,4,6,2,0,0,0,0,15293,6.8,17871,204,56,-1306,-998,20.4,1529.3,18,3,0,6,4,9,2,1,1,0,16599,7.0,18869,221,52,1306,998,22.1,1659.9
4520302933,48,4,1,7,3,9,2,1,1,1,17669,7.0,18012,221,47,2925,1304,22.1,1766.9,14,2,0,3,7,5,0,0,0,0,14744,6.6,16708,219,52,-2925,-1304,21.9,1474.4
4515231062,16,3,0,4,9,4,1,1,0,0,14588,6.2,15647,207,45,-2627,-4080,20.7,1458.8,36,2,1,9,4,4,1,0,1,0,17215,7.4,19727,225,51,2627,4080,22.5,1721.5
4509051206,15,1,1,12,5,13,0,0,0,0,19292,7.2,18153,210,34,4641,2291,21.0,1929.2,17,1,0,5,12,5,1,1,0,0,14651,6.6,15862,172,52,-4641,-2291,17.2,1465.1
4515517372,17,5,0,2,2,2,0,0,0,0,15423,6.8,18333,227,60,699,753,22.7,1542.3,16,2,1,2,2,3,1,1,0,0,14724,6.8,17580,232,46,-699,-753,23.2,1472.4
4526910124,13,1,1,7,6,9,0,0,0,0,17740,7.0,18658,252,37,1419,1036,25.2,1774.0,13,5,0,6,7,7,2,1,1,0,16321,6.8,17622,215,56,-1419,-1036,21.5,1632.1
4505381555,15,1,0,5,7,12,1,1,0,0,15218,6.4,16410,198,44,-2060,-2850,19.8,1521.8,18,1,1,7,5,6,0,0,0,0,17278,7.2,19260,240,47,2060,2850,24.0,1727.8
4522256108,80,2,1,7,11,4,1,0,1,0,15904,6.4,15750,198,36,-1597,-1321,19.8,1590.4,16,3,0,11,7,15,1,1,0,0,17501,6.8,17071,170,63,1597,1321,17.0,1750.1
4509589971,41,5,1,8,5,7,1,1,0,0,17209,7.2,18853,219,54,2481,1962,21.9,1720.9,18,3,0,5,8,3,0,0,0,0,14728,6.8,16891,195,46,-2481,-1962,19.5,1472.8
4482389592,16,3,0,7,5,9,1,1,0,0,16460,7.0,18782,222,52,192,616,22.2,1646.0,52,1,1,5,7,8,0,0,0,0,16268,7.2,18166,236,46,-192,-616,23.6,1626.8
4516988752,13,1,0,3,9,3,0,0,0,0,14232,6.8,17038,186,56,-3082,-646,18.6,1423.2,15,3,1,9,3,14,1,1,0,0,17314,6.8,17684,208,48,3082,646,20.8,1731.4
4466272322,15,4,1,6,3,8,1,1,0,1,18247,7.0,18839,235,59,3400,2400,23.5,1824.7,39,1,0,3,6,3,1,0,1,0,14847,6.6,16439,209,48,-3400,-2400,20.9,1484.7
4457100198,38,1,1,5,3,5,0,0,0,0,15999,7.0,18110,211,45,497,-743,21.1,1599.9,14,1,0,3,5,3,0,0,0,0,15502,7.2,18853,229,60,-497,743,22.9,1550.2
4509719745,44,6,0,13,6,13,0,0,0,0,18933,7.4,19905,210,45,2109,3154,21.0,1893.3,19,2,1,6,13,10,0,0,0,0,16824,6.6,16751,194,50,-2109,-3154,19.4,1682.4
4526481704,16,0,0,6,7,8,0,0,0,0,15779,6.8,17436,186,31,-1219,-737,18.6,1577.9,14,3,1,7,6,10,2,1,1,0,16998,7.2,18173,242,52,1219,737,24.2,1699.8
4452471591,22,3,1,12,3,11,1,1,0,0,18428,7.0,18214,218,47,3117,1745,21.8,1842.8,39,6,0,3,12,4,0,0,0,0,15311,6.6,16469,254,28,-3117,-1745,25.4,1531.1
4487632164,17,5,1,11,7,12,0,0,0,0,19308,7.2,18764,243,49,2036,2183,24.3,1930.8,17,2,0,7,11,9,0,0,0,0,17272,6.6,16581,164,44,-2036,-2183,16.4,1727.2
4487407222,11,1,0,3,12,3,0,0,0,0,14202,6.4,16159,200,42,-4552,-2289,20.0,1420.2,14,3,1,12,3,16,1,1,0,0,18754,7.2,18448,223,35,4552,2289,22.3,1875.4
4524926639,16,3,1,8,6,12,0,0,0,0,16808,6.8,16741,200,44,616,-87,20.0,1680.8,16,4,0,6,8,8,0,0,0,0,16192,6.6,16828,198,48,-616,87,19.8,1619.2
4518119286,17,0,1,6,6,7,1,1,0,0,16521,6.8,17859,214,56,90,-1069,21.4,1652.1,17,1,0,6,6,3,1,0,1,0,16431,7.2,18928,243,52,-90,1069,24.3,1643.1
4517503916,15,5,0,6,13,9,1,1,0,0,16035,6.6,16424,160,52,-4685,-3600,16.0,1603.5,19,4,1,13,6,23,0,0,0,0,20720,7.6,20024,244,51,4685,3600,24.4,2072.0
4472981807,17,5,0,6,12,8,0,0,0,0,16240,6.6,16610,209,52,-2156,-1052,20.9,1624.0,47,5,1,12,6,12,1,1,0,0,18396,7.0,17662,167,44,2156,1052,16.7,1839.6
4520703229,59,2,0,5,5,4,0,0,0,0,16355,6.6,17606,221,52,-1874,-1002,22.1,1635.5,17,1,1,5,5,5,1,0,1,2,18229,7.2,18608,205,60,1874,1002,20.5,1822.9
4465134989,22,7,1,6,3,5,1,1,0,0,16942,7.0,18645,216,71,2032,2196,21.6,1694.2,85,4,0,3,6,3,0,0,0,0,14910,6.4,16449,210,48,-2032,-2196,21.0,1491.0
4513746482,16,3,1,5,2,5,2,1,1,0,17665,7.4,19907,258,68,4520,5730,25.8,1766.5,9,1,0,2,5,0,0,0,0,0,13145,5.6,14177,210,29,-4520,-5730,21.0,1314.5
4518394707,38,1,0,6,8,7,1,1,0,0,16877,7.4,19179,225,52,-772,-545,22.5,1687.7,14,0,1,8,6,11,0,0,0,0,17649,7.4,19724,226,59,772,545,22.6,1764.9
4477337521,21,4,0,8,6,12,1,1,0,0,18352,7.2,18953,242,42,1909,1099,24.2,1835.2,14,5,1,6,8,5,0,0,0,0,16443,7.0,17854,225,40,-1909,-1099,22.5,1644.3
4509204216,13,0,0,3,8,2,0,0,0,0,14500,6.6,16097,209,50,-3614,-3434,20.9,1450.0,16,1,1,8,3,10,1,0,1,0,18114,7.2,19531,222,60,3614,3434,22.2,1811.4
4513670045,16,3,0,4,4,6,0,0,0,0,15641,7.2,17857,244,40,-1136,-1235,24.4,1564.1,61,2,1,4,4,3,1,1,0,0,16777,7.2,19092,234,71,1136,1235,23.4,1677.7
4518244695,31,2,0,2,3,4,0,0,0,0,15267,6.8,17987,226,80,-392,-995,22.6,1526.7,18,1,1,3,2,1,1,1,0,0,15659,7.4,18982,254,60,392,995,25.4,1565.9
4525009090,14,0,0,3,7,3,0,0,0,0,15571,7.2,18029,212,60,-1431,-648,21.2,1557.1,15,1,1,7,3,9,1,1,0,0,17002,7.0,18677,241,51,1431,648,24.1,1700.2
4514457087,14,1,1,9,4,11,0,0,0,0,17494,7.0,18057,205,56,1518,-5,20.5,1749.4,13,0,0,4,9,5,1,1,0,0,15976,7.0,18062,199,72,-1518,5,19.9,1597.6
4519085208,15,0,1,4,1,5,1,1,0,0,15942,7.2,19003,232,71,486,865,23.2,1594.2,20,4,0,1,4,2,0,0,0,0,15456,7.0,18138,242,64,-486,-865,24.2,1545.6
4510355472,19,2,1,4,6,1,0,0,0,0,14547,6.4,15883,188,53,-2074,-1795,18.8,1454.7,19,3,0,6,4,5,2,1,1,0,16621,6.8,17678,196,56,2074,1795,19.6,1662.1
4523482490,14,2,0,15,12,14,1,1,0,0,19632,7.6,20057,228,43,84,992,22.8,1963.2,15,6,1,12,15,9,0,0,0,0,19548,7.2,19065,237,40,-84,-992,23.7,1954.8
4523593129,15,4,0,1,5,0,0,0,0,0,13943,6.8,17294,230,55,-4036,-1844,23.0,1394.3,15,3,1,5,1,5,1,1,0,1,17979,7.2,19138,231,65,4036,1844,23.1,1797.9
4494914553,14,2,1,6,4,7,1,1,0,0,16439,7.2,18635,220,56,1603,1799,22.0,1643.9,113,0,0,4,6,1,1,0,1,0,14836,6.6,16836,213,51,-1603,-1799,21.3,1483.6
4519132891,39,2,0,13,10,13,0,0,0,0,18886,7.2,18539,188,56,845,1049,18.8,1888.6,13,1,1,10,13,7,0,0,0,0,18041,7.0,17490,214,39,-845,-1049,21.4,1804.1
4472056933,15,1,1,12,6,16,0,0,0,0,18850,6.8,17995,216,55,3293,987,21.6,1885.0,13,3,0,6,12,7,0,0,0,0,15557,6.8,17008,210,37,-3293,-987,21.0,1555.7
4522611755,16,3,1,7,4,5,1,1,0,0,17773,7.0,18860,262,48,2521,2240,26.2,1777.3,19,3,0,4,7,4,0,0,0,0,15252,6.6,16620,197,51,-2521,-2240,19.7,1525.2
4519675150,20,4,0,7,3,8,1,1,0,0,16628,6.8,17255,215,52,-105,1234,21.5,1662.8,18,2,1,3,7,5,1,0,1,1,16733,6.2,16021,213,46,105,-1234,21.3,1673.3
4526734113,17,3,1,8,5,12,0,0,0,0,17469,7.0,18265,242,44,1625,121,24.2,1746.9,14,2,0,5,8,4,0,0,0,0,15844,6.8,18144,236,51,-1625,-121,23.6,1584.4
4518387667,16,5,1,11,5,8,1,1,0,0,17522,7.0,18787,204,44,2123,1612,20.4,1752.2,37,2,0,5,11,3,0,0,0,0,15399,7.0,17175,194,52,-2123,-1612,19.4,1539.9
4513150611,13,3,0,6,10,5,0,0,0,0,15796,6.6,17324,195,59,-2815,-2607,19.5,1579.6,14,6,1,10,6,11,1,1,0,0,18611,7.6,19931,243,72,2815,2607,24.3,1861.1
4460577454,20,4,0,4,4,5,2,1,1,0,16486,7.2,18617,256,60,1118,871,25.6,1648.6,21,3,1,4,4,6,0,0,0,0,15368,6.8,17746,224,43,-1118,-871,22.4,1536.8
4520909280,15,3,0,4,11,2,1,1,0,0,15011,6.6,16617,183,60,-4396,-2703,18.3,1501.1,14,3,1,11,4,16,0,0,0,0,19407,7.2,19320,245,40,4396,2703,24.5,1940.7
4524928050,60,1,0,5,11,2,0,0,0,0,15346,6.4,15646,187,38,-2764,-2934,18.7,1534.6,12,5,1,11,5,13,1,1,0,0,18110,7.2,18580,202,44,2764,2934,20.2,1811.0
4496994572,15,1,0,2,8,0,1,0,1,0,14591,6.8,17470,219,60,-2269,-1078,21.9,1459.1,34,4,1,8,2,7,1,1,0,0,16860,7.2,18548,223,42,2269,1078,22.3,1686.0
4522461341,15,13,0,3,9,1,1,1,0,0,14711,6.8,18284,204,52,-3559,-1400,20.4,1471.1,42,3,1,9,3,7,0,0,0,0,18270,7.2,19684,256,43,3559,1400,25.6,1827.0
4449452387,18,1,0,5,5,1,1,1,0,1,15891,6.4,15926,179,36,-498,-1785,17.9,1589.1,13,3,1,5,5,4,0,0,0,0,16389,6.8,17711,196,55,498,1785,19.6,1638.9
4522498340,14,2,1,11,6,10,1,1,0,1,19517,7.0,18337,216,50,3304,-85,21.6,1951.7,53,1,0,6,11,7,0,0,0,0,16213,7.0,18422,208,52,-3304,85,20.8,1621.3
4455324807,43,0,0,7,10,5,0,0,0,0,17444,7.2,18454,197,56,-180,-102,19.7,1744.4,17,1,1,10,7,12,2,1,1,0,17624,7.0,18556,204,52,180,102,20.4,1762.4
4456177266,13,1,1,6,8,5,0,0,0,0,16459,7.0,18612,201,58,-2021,-1891,20.1,1645.9,20,0,0,8,6,7,0,0,0,0,18480,7.4,20503,235,80,2021,1891,23.5,1848.0
4509818939,66,4,0,1,7,1,0,0,0,0,14252,6.6,16567,229,47,-4219,-3256,22.9,1425.2,78,2,1,7,1,9,2,1,1,0,18471,7.2,19823,268,59,4219,3256,26.8,1847.1
4523335344,8,3,0,5,11,6,0,0,0,0,14784,6.4,15775,173,40,-3584,-3674,17.3,1478.4,21,0,1,11,5,8,0,0,0,0,18368,7.2,19449,211,60,3584,3674,21.1,1836.8
4509803482,16,2,1,8,7,11,0,0,0,0,16776,6.4,15799,196,39,357,-26,19.6,1677.6,16,3,0,7,8,7,0,0,0,0,16419,6.2,15825,186,36,-357,26,18.6,1641.9
4501265779,12,2,0,8,6,7,0,0,0,0,16793,6.8,17595,210,36,115,-80,21.0,1679.3,14,3,1,6,8,6,1,1,0,0,16678,6.8,17675,238,41,-115,80,23.8,1667.8
4491707815,18,4,0,13,2,18,0,0,0,0,19470,7.4,20453,243,51,6297,5777,24.3,1947.0,16,4,1,2,13,1,1,1,0,0,13173,6.0,14676,189,42,-6297,-5777,18.9,1317.3
4526731314,18,3,1,5,6,6,1,0,1,0,15743,6.6,16662,212,48,-720,-1533,21.2,1574.3,21,5,0,6,5,11,1,1,0,0,16463,7.0,18195,229,48,720,1533,22.9,1646.3
4526119590,17,3,1,11,8,10,0,0,0,0,18459,7.0,17481,224,39,1536,624,22.4,1845.9,15,1,0,8,11,12,1,1,0,0,16923,6.6,16857,197,55,-1536,-624,19.7,1692.3
4499732263,16,4,0,4,12,2,0,0,0,0,14997,6.8,17191,218,44,-3401,-2179,21.8,1499.7,18,2,1,12,4,15,2,1,1,0,18398,7.4,19370,219,40,3401,2179,21.9,1839.8
4527171182,16,1,1,8,1,6,1,0,1,2,18618,7.2,19304,223,39,4343,2636,22.3,1861.8,29,4,0,1,8,1,0,0,0,0,14275,6.8,16668,190,75,-4343,-2636,19.0,1427.5
4510821185,19,5,0,6,6,4,0,0,0,0,16839,7.0,18230,222,57,468,370,22.2,1683.9,19,3,1,6,6,8,1,1,0,0,16371,6.8,17860,211,58,-468,-370,21.1,1637.1
4519651388,13,2,1,10,16,7,0,0,0,0,16759,6.4,15499,163,37,-4236,-4211,16.3,1675.9,15,2,0,16,10,15,1,1,0,0,20995,7.4,19710,187,46,4236,4211,18.7,2099.5
4521525873,13,1,1,6,8,4,0,0,0,0,16112,6.8,17371,197,50,-554,-483,19.7,1611.2,17,3,0,8,6,10,1,1,0,0,16666,7.0,17854,206,41,554,483,20.6,1666.6
4452642610,14,1,1,9,4,9,0,0,0,0,18751,7.2,20236,249,58,4671,4193,24.9,1875.1,36,1,0,4,9,5,1,1,0,0,14080,6.6,16043,177,57,-4671,-4193,17.7,1408.0
4520617571,15,3,1,8,7,8,2,1,1,0,16412,7.0,18381,212,44,151,840,21.2,1641.2,12,3,0,7,8,5,0,0,0,0,16261,7.0,17541,212,52,-151,-840,21.2,1626.1
4515867016,13,2,0,4,3,6,1,1,0,0,14972,6.8,17357,201,49,-266,-613,20.1,1497.2,37,1,1,3,4,4,1,0,1,0,15238,7.0,17970,233,46,266,613,23.3,1523.8
4461787791,89,3,1,7,5,7,1,1,0,0,17488,7.2,18635,220,51,1902,967,22.0,1748.8,54,6,0,5,7,6,0,0,0,0,15586,7.0,17668,193,60,-1902,-967,19.3,1558.6
4525813376,53,5,0,5,11,5,0,0,0,0,15189,7.0,17359,195,48,-4907,-2701,19.5,1518.9,18,3,1,11,5,8,1,1,0,1,20096,7.4,20060,250,51,4907,2701,25.0,2009.6
4527238809,14,3,1,5,8,6,0,0,0,0,14557,6.4,15691,169,52,-3666,-2993,16.9,1455.7,17,2,0,8,5,8,0,0,0,0,18223,7.2,18684,235,52,3666,2993,23.5,1822.3
4477292734,16,2,0,2,11,5,0,0,0,0,14486,6.4,15896,207,51,-3576,-3516,20.7,1448.6,88,3,1,11,2,11,1,0,1,0,18062,7.2,19412,205,56,3576,3516,20.5,1806.2
4509007045,23,4,1,8,9,9,1,0,1,0,17610,6.8,17779,212,52,-1168,-674,21.2,1761.0,55,2,0,9,8,17,1,1,0,0,18778,7.2,18453,229,54,1168,674,22.9,1877.8
4450445125,13,3,0,0,5,0,1,0,1,0,14103,6.6,17162,230,66,-1977,-700,23.0,1410.3,13,3,1,5,0,4,0,0,0,0,16080,7.0,17862,224,54,1977,700,22.4,1608.0
4500756552,41,2,1,8,4,10,0,0,0,0,16929,7.0,18100,200,48,1134,1146,20.0,1692.9,19,3,0,4,8,3,1,1,0,0,15795,6.6,16954,239,52,-1134,-1146,23.9,1579.5
4500435110,132,0,0,13,5,8,0,0,0,3,22845,7.4,19608,250,51,8234,6026,25.0,2284.5,24,2,1,5,13,5,0,0,0,0,14611,6.0,13582,158,40,-8234,-6026,15.8,1461.1
4508126925,16,3,1,16,7,22,2,1,1,0,21512,7.2,19190,218,35,5514,3051,21.8,2151.2,18,2,0,7,16,9,0,0,0,0,15998,6.4,16139,196,47,-5514,-3051,19.6,1599.8
4475216536,18,1,1,11,7,21,1,1,0,0,18997,7.2,17998,237,45,1373,57,23.7,1899.7,18,4,0,7,11,7,0,0,0,0,17624,6.8,17941,227,48,-1373,-57,22.7,1762.4
4522531124,22,4,1,9,3,9,0,0,0,0,17270,6.6,17435,213,43,2318,1656,21.3,1727.0,17,6,0,3,9,3,0,0,0,0,14952,6.6,15779,220,44,-2318,-1656,22.0,1495.2
4521510642,41,4,1,7,4,7,2,1,1,0,18047,7.2,19362,228,64,3255,2259,22.8,1804.7,18,5,0,4,7,3,0,0,0,0,14792,6.8,17103,197,52,-3255,-2259,19.7,1479.2
4449504375,15,9,0,13,5,10,2,1,1,0,20038,7.8,21588,222,71,4079,5568,22.2,2003.8,39,1,1,5,13,6,0,0,0,0,15959,6.6,16020,208,40,-4079,-5568,20.8,1595.9
4454573791,20,7,1,4,8,7,1,0,1,0,15228,6.8,16963,198,52,-2236,-2070,19.8,1522.8,20,5,0,8,4,8,1,1,0,0,17464,7.2,19033,227,48,2236,2070,22.7,1746.4
4508876664,17,2,1,8,1,5,1,1,0,2,19820,7.2,19369,247,63,6883,5337,24.7,1982.0,13,1,0,1,8,1,1,0,1,0,12937,6.0,14032,179,37,-6883,-5337,17.9,1293.7
4516145589,15,1,0,9,9,11,0,0,0,0,18026,7.0,18214,211,56,894,639,21.1,1802.6,11,3,1,9,9,8,0,0,0,0,17132,6.8,17575,195,47,-894,-639,19.5,1713.2
4527490147,9,2,0,3,12,0,0,0,0,0,14798,6.8,17372,225,48,-5533,-2481,22.5,1479.8,79,5,1,12,3,13,0,0,0,0,20331,7.6,19853,233,49,5533,2481,23.3,2033.1
4467269037,21,4,1,5,1,6,1,1,0,0,16956,7.2,18750,259,56,1723,740,25.9,1695.6,14,2,0,1,5,1,1,0,1,0,15233,6.8,18010,262,64,-1723,-740,26.2,1523.3
4498068359,13,2,0,3,7,2,0,0,0,0,15412,6.8,17502,211,45,-3768,-2111,21.1,1541.2,16,3,1,7,3,9,2,1,1,1,19180,7.4,19613,246,64,3768,2111,24.6,1918.0
4457833778,17,1,1,5,6,5,0,0,0,0,16781,6.8,18303,222,48,679,1400,22.2,1678.1,17,0,0,6,5,6,1,1,0,0,16102,6.6,16903,192,57,-679,-1400,19.2,1610.2
4496336635,35,2,1,3,6,5,0,0,0,0,14703,6.8,16970,198,36,-2127,-1619,19.8,1470.3,18,2,0,6,3,10,1,1,0,0,16830,7.0,18589,233,55,2127,1619,23.3,1683.0
4465188797,14,1,1,6,7,5,0,0,0,0,15891,7.0,17964,207,41,-1190,-911,20.7,1589.1,14,1,0,7,6,4,0,0,0,0,17081,7.0,18875,224,54,1190,911,22.4,1708.1
4524590914,15,3,0,7,11,4,0,0,0,0,15967,6.8,17259,205,47,-2068,36,20.5,1596.7,22,5,1,11,7,12,0,0,0,0,18035,6.8,17223,210,28,2068,-36,21.0,1803.5
4505630754,18,2,1,6,5,4,0,0,0,0,16304,6.8,17893,209,50,-794,-951,20.9,1630.4,13,3,0,5,6,3,0,0,0,0,17098,7.2,18844,220,73,794,951,22.0,1709.8
4481998895,15,1,0,9,4,12,1,1,0,0,18055,6.8,17444,212,50,3332,2911,21.2,1805.5,14,0,1,4,9,8,0,0,0,0,14723,6.2,14533,186,41,-3332,-2911,18.6,1472.3
4524577169,20,5,1,9,8,13,1,1,0,0,17283,6.6,16810,205,28,-428,5,20.5,1728.3,18,3,0,8,9,7,1,0,1,0,17711,6.6,16805,213,36,428,-5,21.3,1771.1
4515231916,70,6,0,1,7,0,1,1,0,0,13789,6.8,16947,210,63,-4038,-2854,21.0,1378.9,20,7,1,7,1,12,0,0,0,0,17827,7.4,19801,252,52,4038,2854,25.2,1782.7
4475925954,14,1,1,4,12,5,0,0,0,0,15056,6.4,16369,198,46,-3772,-3034,19.8,1505.6,13,1,0,12,4,20,1,1,0,1,18828,7.4,19403,177,53,3772,3034,17.7,1882.8
4526220423,39,4,0,4,8,5,0,0,0,0,15124,6.6,16323,185,50,-2588,-1355,18.5,1512.4,16,6,1,8,4,9,0,0,0,0,17712,6.8,17678,217,43,2588,1355,21.7,1771.2
4502988804,14,5,0,2,8,2,0,0,0,0,14177,6.4,15427,196,54,-2115,-2872,19.6,1417.7,18,2,1,8,2,18,1,1,0,0,16292,7.0,18299,200,43,2115,2872,20.0,1629.2
4487544750,26,5,0,8,5,8,1,1,0,0,17346,7.0,18654,208,52,1482,1629,20.8,1734.6,19,0,1,5,8,6,0,0,0,0,15864,6.8,17025,211,47,-1482,-1629,21.1,1586.4
4502673310,28,2,0,3,7,3,0,0,0,0,14525,6.6,16786,201,56,-5011,-2444,20.1,1452.5,22,1,1,7,3,5,0,0,0,1,19536,7.2,19230,244,52,5011,2444,24.4,1953.6
4526407759,18,4,1,8,6,6,1,1,0,0,16166,6.8,17100,188,49,-209,-353,18.8,1616.6,16,3,0,6,8,9,0,0,0,0,16375,7.0,17453,215,59,209,353,21.5,1637.5
4524144902,13,1,1,6,8,13,0,0,0,0,15835,6.8,17352,217,40,-1973,-1497,21.7,1583.5,14,1,0,8,6,8,0,0,0,0,17808,7.2,18849,236,60,1973,1497,23.6,1780.8
4500738441,23,2,1,5,9,4,0,0,0,0,15675,6.6,16844,229,39,-1614,-2256,22.9,1567.5,14,3,0,9,5,12,1,1,0,0,17289,7.2,19100,215,56,1614,2256,21.5,1728.9
4502364167,16,1,0,5,7,9,0,0,0,0,16427,7.2,18653,248,44,-311,-544,24.8,1642.7,55,1,1,7,5,10,0,0,0,0,16738,7.2,19197,227,32,311,544,22.7,1673.8
4479922786,16,2,0,7,8,7,0,0,0,0,16093,6.4,16567,175,40,-1805,-2047,17.5,1609.3,32,6,1,8,7,9,1,1,0,0,17898,6.8,18614,238,48,1805,2047,23.8,1789.8
4470054451,12,4,1,10,4,14,1,1,0,0,18374,7.6,20120,229,51,3823,3324,22.9,1837.4,15,2,0,4,10,4,0,0,0,0,14551,6.6,16796,176,52,-3823,-3324,17.6,1455.1
4461986866,86,3,1,6,4,10,0,0,0,0,17275,7.2,19289,241,44,1702,1352,24.1,1727.5,14,1,0,4,6,4,1,1,0,0,15573,6.8,17937,234,60,-1702,-1352,23.4,1557.3
4492904211,15,2,1,3,3,3,2,1,1,0,15284,7.2,18267,245,51,-884,-471,24.5,1528.4,17,1,0,3,3,2,0,0,0,0,16168,7.2,18738,227,71,884,471,22.7,1616.8
4457422227,16,2,0,7,8,10,0,0,0,0,16808,6.8,17371,189,60,-400,-539,18.9,1680.8,16,2,1,8,7,5,1,1,0,0,17208,7.2,17910,194,61,400,539,19.4,1720.8
4488805966,12,2,1,7,4,7,1,1,0,0,15680,6.6,17099,186,52,-259,-1115,18.6,1568.0,37,1,0,4,7,4,0,0,0,0,15939,7.0,18214,227,51,259,1115,22.7,1593.9
4513601289,14,2,1,8,7,14,0,0,0,0,17077,6.6,16354,171,56,974,-1050,17.1,1707.7,16,1,0,7,8,4,1,1,0,0,16103,6.8,17404,200,48,-974,1050,20.0,1610.3
4526110016,14,2,0,3,7,2,0,0,0,0,14415,6.8,17890,213,61,-3505,-1473,21.3,1441.5,18,3,1,7,3,9,1,1,0,0,17920,7.2,19363,226,70,3505,1473,22.6,1792.0
4511051956,18,3,1,5,5,4,0,0,0,0,16864,7.0,18195,247,51,874,-554,24.7,1686.4,17,2,0,5,5,5,2,1,1,0,15990,7.2,18749,232,56,-874,554,23.2,1599.0
4484505320,13,3,1,10,6,9,1,0,1,1,19793,7.4,19966,243,65,3387,1454,24.3,1979.3,54,2,0,6,10,9,1,1,0,0,16406,7.0,18512,239,50,-3387,-1454,23.9,1640.6
4491630754,17,6,0,7,8,8,0,0,0,0,15956,6.8,17011,191,51,-1206,-963,19.1,1595.6,19,5,1,8,7,7,1,1,0,0,17162,7.0,17974,243,44,1206,963,24.3,1716.2
4472644738,18,3,1,8,10,7,0,0,0,0,16403,7.0,18111,218,33,-1445,-736,21.8,1640.3,56,7,0,10,8,9,1,0,1,0,17848,7.0,18847,210,54,1445,736,21.0,1784.8
4473252626,18,4,1,12,13,15,1,0,1,0,18275,6.6,17102,173,39,-1963,-1936,17.3,1827.5,19,5,0,13,12,20,1,1,0,0,20238,7.2,19038,214,49,1963,1936,21.4,2023.8
4483466671,22,2,0,7,6,10,0,0,0,1,18376,7.0,17877,225,48,2595,776,22.5,1837.6,33,4,1,6,7,4,2,1,1,0,15781,6.6,17101,201,59,-2595,-776,20.1,1578.1
4524709324,16,1,1,5,6,5,1,1,0,0,15706,6.6,17219,228,43,-469,-1237,22.8,1570.6,19,5,0,6,5,4,0,0,0,0,16175,7.0,18456,229,56,469,1237,22.9,1617.5
4524571135,19,4,0,3,11,4,0,0,0,0,14414,6.4,16744,173,39,-4743,-2650,17.3,1441.4,16,1,1,11,3,10,2,1,1,0,19157,7.4,19394,245,52,4743,2650,24.5,1915.7
4496821254,15,2,1,9,6,9,2,1,1,0,18050,7.4,19654,239,37,1949,214,23.9,1805.0,12,1,0,6,9,2,0,0,0,0,16101,7.0,19440,214,58,-1949,-214,21.4,1610.1
4492674623,14,1,1,10,3,8,1,0,1,1,20173,7.4,20931,248,56,6281,4551,24.8,2017.3,16,0,0,3,10,0,1,1,0,0,13892,6.6,16380,204,40,-6281,-4551,20.4,1389.2
4513807065,19,4,1,6,10,9,0,0,0,0,16758,7.0,17743,243,43,-1356,-1064,24.3,1675.8,17,4,0,10,6,15,0,0,0,0,18114,7.2,18807,207,52,1356,1064,20.7,1811.4
4523590647,21,2,1,6,2,3,0,0,0,0,16818,7.2,19595,250,56,2274,2694,25.0,1681.8,12,1,0,2,6,2,0,0,0,0,14544,6.8,16901,202,50,-2274,-2694,20.2,1454.4
4459426947,16,2,0,5,6,5,1,1,0,0,16842,7.0,18443,221,58,-259,-1001,22.1,1684.2,16,4,1,6,5,6,0,0,0,0,17101,7.4,19444,247,64,259,1001,24.7,1710.1
4512194286,14,1,0,3,8,1,0,0,0,0,15539,6.8,17792,214,72,-2925,-2112,21.4,1553.9,20,3,1,8,3,9,2,1,1,0,18464,7.2,19904,242,47,2925,2112,24.2,1846.4
4500144079,24,3,1,4,7,4,1,1,0,0,15712,6.8,17100,213,51,-418,15,21.3,1571.2,19,5,0,7,4,11,0,0,0,0,16130,6.8,17085,166,53,418,-15,16.6,1613.0
4509942464,18,2,0,8,4,11,1,1,0,0,17255,7.0,18288,237,43,2116,1613,23.7,1725.5,15,3,1,4,8,5,0,0,0,0,15139,6.6,16675,203,52,-2116,-1613,20.3,1513.9
4446037878,23,3,0,7,5,9,0,0,0,0,16219,7.2,17966,197,40,709,1449,19.7,1621.9,17,5,1,5,7,5,1,1,0,0,15510,6.4,16517,199,44,-709,-1449,19.9,1551.0
4521032277,16,3,0,7,7,7,2,1,1,0,17239,7.4,19174,222,48,1167,2368,22.2,1723.9,12,2,1,7,7,7,0,0,0,0,16072,6.6,16806,182,58,-1167,-2368,18.2,1607.2
4489207578,15,7,1,4,5,4,0,0,0,0,15079,7.0,18092,196,55,-1226,-1378,19.6,1507.9,39,3,0,5,4,3,0,0,0,0,16305,7.2,19470,261,56,1226,1378,26.1,1630.5
4522584665,40,3,1,5,3,3,0,0,0,0,17194,7.4,19447,263,61,2588,1628,26.3,1719.4,14,2,0,3,5,3,0,0,0,0,14606,7.0,17819,215,37,-2588,-1628,21.5,1460.6
4476200313,16,4,0,8,2,6,1,1,0,0,17315,7.2,18903,232,47,4064,3736,23.2,1731.5,16,6,1,2,8,1,0,0,0,0,13251,6.2,15167,181,45,-4064,-3736,18.1,1325.1
4514424102,16,2,0,6,3,5,1,1,0,0,15690,6.8,17299,214,44,903,1110,21.4,1569.0,13,2,1,3,6,3,0,0,0,0,14787,6.8,16189,199,52,-903,-1110,19.9,1478.7
4507786946,16,2,1,7,6,7,2,1,1,0,17453,7.0,17851,237,49,1478,483,23.7,1745.3,36,2,0,6,7,8,0,0,0,0,15975,7.0,17368,199,62,-1478,-483,19.9,1597.5
4524415638,15,2,1,5,6,4,0,0,0,0,15109,7.0,18112,213,43,-1493,-382,21.3,1510.9,98,3,0,6,5,2,1,1,0,0,16602,7.0,18494,230,52,1493,382,23.0,1660.2
4525093722,17,2,1,15,7,19,1,1,0,0,20833,7.6,20278,231,36,4882,2906,23.1,2083.3,14,3,0,7,15,5,0,0,0,0,15951,6.8,17372,202,44,-4882,-2906,20.2,1595.1
4516594125,14,3,0,7,3,8,1,1,0,0,16858,7.0,18658,228,40,1160,1541,22.8,1685.8,22,4,1,3,7,6,0,0,0,0,15698,6.6,17117,244,58,-1160,-1541,24.4,1569.8
